<source>iPhone 7 Plus</source>
<title></title>
<time>2020-3-26 18:22</time>
<url>https://weibo.com/1229253383/IAoVPot2I</url>


<text>财|入门|2020|3|26|15|59|已|编辑|浙江|新增|两例|境外|输入|病例|其中|杭州|一例|为|法国|输入|嘉兴|一例|为|西班牙|输入|杭州|萧山|新塘|黎南|名苑|一名|归国|留学生|确诊|病人|20|号|法国|回|杭州|萧山|在家|隔离|23|号|开始|发热|咳嗽|而|嘉兴|那个|是|在|集中|隔离|点|影响|较|小|同一|省|不同|市|采取|了|不同|措施|结果|也|不同|或许|说明|我们|在|境外|输入|管理|上|还|存在|漏洞|这么|下去|何时|才能|恢复正常|生活|和|出行|关于|浙江|针对|境外|回国|人员|的|防控|措施|隔离|要求|很多|人|不|知道|是|什么|时候|发布|的|我|找|了|一下|根据|公开|信息|应该|是|18|号|发布|的|已有|23|个|省份|报告|境外|输入|病例|国家|卫健委|提醒|做好|持久|防控|准备|#</text>
<comments>集中|隔离|要求|何时|出|的|O|财|入门
杭州|能|让|通过|和|领导|打招呼|而|更改|让|16|岁|留学生|居家|隔离|可知|防疫|受太多|人为因素|干扰|官本位|还是|大|因素| |而|留学生|太|自私|既然|回来|为何|不能|到|隔离|点|隔离|为何|不|隔离|14|天后|再|回家|非要|祸祸|自家|老人
谁|能|告诉|我|她|几号|去|的|商业城|是|去|市场|里面|了|吗|MD|害人|啊
卧槽|杭州|官员|给|我|全部|剥腹|传染|开来|不得了|大家|不要|出去
杭州|就是|牛|逼
为什么|就|不能|集中|隔离|呢|！
央视|新闻| |附近|镇|的|每天|上下班|必经|路|萧山|上下班|高峰|最|拥堵|的|路|就|从|小区|前|穿过|太|害人|了
不要|造谣|不信谣|不|传谣|！
坑|全家|坑全|小区|系列|还|不|知道|有没有|乱跑|谁|来|负责|任
别|胡说八道|了|密切接触|者|是从|浦东|机场|到|杭州|期间|的|接触|人员|和|居家|隔离|没有|关系|江浙沪|的|居家|隔离|都|有|磁性|感应器|开门|就|会|向|居委会|和|派出所|报警|安全|的|很
转机|国内|的|境外|人士|怎么|判断|的|不要|告诉|我|只有|量体温|就|放行|南无|阿弥陀佛|了|那|马上|二次|高峰|不是|梦|了
居家|隔离|不是|要|安装|那个|啥|吗|所以|她|真的|不|听|招呼|又|确诊|了|是不是|要|立案|啊
难怪|今天|突然|又|开始|看|健康|码|了
建议|核实|真实情况
把|或许|去掉
姐们|离|海宁|这么|近|最近|刚|开始|有点|恢复正常|又|来|一个
全世界|手挽手|肩并肩|才|是|战胜|新冠|肺炎|病毒|的|唯一|途径
境外|政策|出|的|太晚|了|前面|回来|的|估计|确诊|比例|高
在家|隔离|对|邻居|不|公平|吧|如果|确证|那|岂|不是|一栋|楼|都|要|隔离
巷子|里|的|手风琴|浙江|管理|漏洞|挺大|的|要|小心|啊
上海|总于|全部|隔离|了|抖抖|抖
门上|没有|贴|隔离|封条|吗|居然|还|能|自由|出入
夏小天|人|Lazy|张博
假消息|可以|不要|乱传|吗
我们|公司|已经|不发|口罩|了|不|测温|了|都|松懈|了
西湖区|的|没|爆|萧山区|爆|了
应当|全国一盘棋|对|所有|入境|人员|都|采取|就|地|强制|隔离|两周|措施|才能|从根本上|杜绝|疫情|输入|扩散|风险
一律|集中|隔离|两周|时间|能|安全|为何|非得|开后门|居家|隔离|谁|同意|的|谁|开后门|的|查|严查|为了|小区|其他|居民|安全
江苏省|前|几天|发布|了|一律|集中|隔离|14|天|百分百|检测|就是|不|知道|会|不会|有|漏网之鱼|太难|了|这样|反输|我们|用|归|盼|不到|头
浙江|是|全国|最早|复工|的|杭州|尤其|最急|企业|也|是|每天|催|员工|赶紧|回来|复工|这个|事情|事后诸葛亮|看|可以|说|是|个|必然|事件</comments>