<source>iPhone 7 Plus</source>
<title></title>
<time>2020-3-28 18:35</time>
<url>https://weibo.com/2174585797/IAvb3vkaR</url>


<text>王冰|汝|2020|3|27|07|53|美国|疫情|最|尴尬|的|一次|采访|大名鼎鼎|的|纳|瓦罗|上|CNN|一|上来|就|想|把|美国|疫情|甩锅|给|中国|和|奥巴马|政府|结果|CNN|主播|说|请|你|不要|浪费|我|时间|你们|自己|应对|不力|然后|两人|一顿|鸡同鸭讲|之后|纳|瓦罗|在|节目|最后|不|忘|再次|甩锅|主持人|听|不|下去|了|说|你|不要|浪费|节目|时间|了|别说|了|太|荒谬|了| |L|王冰|汝|的|微博|视频</text>
<comments>哈哈哈|奥巴马|说|当初|H1N1|我|把|锅|甩出去|了|现在|你们|甩|不|出去|还|怪|我|是|你|甩|锅|技术|不行|啊
昨天|还|不|知道|呼吸机|怎么|搞定|的|纳|瓦罗|刚刚|被|特朗普|任命|为|国防|生产|法|政策|协调员|根据|国防|生产|法|特朗普|政府|将|有权|要|bi|求|po|通用汽车|生产|呼吸机
美国|这些|官|真的|是|厚颜无耻|武汉|一月|二十三|号|封城|你|自己|在|当地|的|侨|都|撤|了|现在|居然|敢|说|自己|完全|不|知道|发生|什么|没|看|新闻|的|吗
真是|个|糟糕|的|主持人
还|扯|奥巴马|啊|哈哈
12|月|中旬|这锅|甩|的|12|月|中旬|是|真不知道|啊|。
这个|主持人|干得|漂亮|小王|注意|保护|自己|防护|好|啊
真是|个|糟糕|的|电视台|竟然|不|听|政府|官员|的话
米国|这些|政客|啊|都|什么|时候|了|不|把|所有|精力|放在|对|抗病毒|上|还|搞些|没用|的|草菅人命
为什么|老要|等|人|通知|提前|通知|中国|发生|疫情|也|没人|提前|通知|啊|现在|不|也|控制|的|差不多|了|吗|何况|美国|已经|知道|疫情|2|个|多月|了|现在|还是|手忙脚乱|忙|着|甩|锅|只能|说明|美国联邦政府|的|无能
原来|美国|媒体|连|美国|高官|也|受不了|啊
唢呐|都|吹|了|两个|月|了|你们|还|说|没|吹哨
冰汝|美国|已经|沦陷|了|回来|吧
汝冰|加油|注意|防护
政客|满嘴|跑|火车|啊|很|好|诠释|了|又|蠢|又|坏
这|算是|民意|开始|公开|大肆|反弹|了|吗|高层|嘴炮|开始|失效|拐点|就|在|美国|成为|最|严重|国家|川普|政府|面临|最大|挑战
假新闻|CNN|美国有线电视新闻网
换个|角度|国内|的|记者|敢|这样|质问|高层|吗
外怪|中国|内怪|奥巴马|美国|是|中国|在|管|还是|奥巴马|在|管
奥巴马|也|他|妈|无辜
他|的|背后|就是|那个|无耻|无知|狂妄自大|的|大|驸马
脸|都|不要|了
特朗普|又|要|发|推特|了|CNN|FAKE|NEWS
这届|美国政府|只会|甩|锅|吗|Welcome|to|the|team
主持人|心里|想|就|不该|请|这|家伙|发表意见|我|自己|说|就|好|了|另外|向|各位|请教|这|一届|政府|中|恨|奥巴马|的|人|真的|那么|多|吗
在|与|病毒|的|战争|中|意大利|迎来|了|拐点|中国|走到|了|终点|美国|找到|了|起点|特朗普|是|全世界|的|焦点
纳|瓦罗|可是|老狐狸
cnn|姓|民主党|fox|姓|共和党
黑蛋|在家|又|打|了|十几个|喷嚏|物以类聚|这话|是|真理|三年|来|大|统领|内阁|还|算|有点|正直|的|蒂|勒斯|塞|申斯们|都|被|赶走|了|现在|上位|的|都|跟|大|统领|一个|模子|坚持|不要脸
这个|主持人|会|不会|悄悄的|的|消失|人们|的|视线|中</comments>