<source>iPhone 7 Plus</source>
<title>“美国人在武汉地铁传播病毒”的视频谣言</title>
<time>2020-3-19 09:38</time>
<url>https://weibo.com/1744259092/IzhVRaoUT</url>


<text>凯迪|网络|2020|3|19|08|20|来自|微博|weibo|com|美国|人|在|武汉|地铁|传播|病毒|的|视频|谣言|目前|可查|到|对|原始|出处|的|视频|进行|编辑|添加|说明|文字|以|造谣|美国|人|在|武汉|地铁|传播|病毒|的|是|加|V|微博|认证|前|贵州省|凯里市|人民政府|义务|监督员|徐锡彪|的|苗乡|布衣|其|发布|时间|是|3|月|16|日|晚上|那|几句|煽动性|的|视频|说明|文字|疑似|苗乡|布衣|的|原创|被|微博|网友|质疑|造谣|后|苗乡|布衣|编辑|删改|了|视频|的|说明|文字|承认|这|令人震惊|的|一幕|发生|在|布鲁塞尔|的|地铁|上|但|推脱|不知|视频|编辑者|缘何|故意|抹黑|美国佬|目前|苗乡|布衣|仍|无法|指出|谁|是|视频|编辑者|再查|造谣|视频|来自|武汉市|的|监控|摄像头|的|最早|的|出处|是|在|路上|的|李掌柜|注明|来自|山东|滨州|嘉合骏恒|文化|公司|的|微博|是|3|月|17|日|下午|发布|的|目前|该|谣言|及|视频|在|微博上|仍|正常|显示| | | | | |不过|3|月|17|日|傍晚|百家|号|河北|网信|管理|执法|发表|军运会|期间|美国|人|在|地铁|中|恶意|传播|病毒|一文|援引|凤凰卫视|欧洲|台|的|官方|微博|凤凰卫视|欧洲|台|关于|这|令人震惊|的|一幕|发生|在|布鲁塞尔|的|地铁|上|的|报道|进行|了|辟谣|...|阅读|全文|请|戳|→|O|网页|链接</text>
<comments>虚假|的|谣言|真实|的|言论|微博|容不得|两秒钟|真正|的|谣言|微博|满天飞
朋友圈|有人|发|信誓旦旦|说真的|我|就|说|看|地铁|门上|的|字|是|中国|的|么|他|就|不|说话|了
这个|不|训诫|吗
冠状病毒|可能|很快|就|会|抑制|住|了|可|精神分裂|病毒|就|难|对付|了|见|谁|咬|谁|见|谁|怼|谁|自己|才|刚刚|从|危难|中|爬|上岸|马上|露出|无耻|的|笑容|对|别人|开始|讥笑|挖苦|谩骂|这些|症状|据说|也|有|办法|医治|资深|中医|大夫|支招|说|灌|大粪
用心|歹毒
但是|这样|的|谣言|不会|被|训诫|啊
脑子|真是|个|好|东西
网络|有|永恒|记忆力
时间|肯定|不是|去年|戴|口罩|嘛|不过|这|是|谁|也|是|戴|口罩|时期|O|网页|链接
美国|人|在|武汉|地铁|传播|病毒|的|视频|谣言|溯源
哪个|城市|的|地铁|是|这种|座位
/|黑板报|的|水晶|这|谣言|老有|影响力|了|连|外交部|发言人|都|上当|了
官窑|能算|窑|吗
WJ|同志|们|不管|管

义和团|2.0
辣鸡
现在|切|不了|在|国内|网站|乱发|美国|生化|袭击|武汉|的|博文|要发|可以|去|推特|或者|油管
转发|微博
是不是|美国|还|真|不好|说
朋友|给|我|看|说|是|武汉|我|说|咱|中国|地铁|不|长|这样
区别|不单是|门上|的|外文|座位|的|造型|和|用材|也|不|像|而且|国内|地铁|座位|都|是|靠|门窗|两侧|造型|也|比较|筒洁|更|不用说|满|车厢|都|是|外国语|难道|我国|军运会|其间|专门|配有|外国人|专用|车厢|这企|不|荒谬
造谣|司|🐴

不要|让|外人|笑|我们|无脑|这种|是|帮倒忙
可是|连|你|转发|个|事实|报道|都|会|被|封号|💣|💣|💣|/|残笑|O|o|相忘|官谣|无罪|…

就是|嘛|武汉|地铁|的|座椅|长|这样|一看|就是|假|的
武汉|9|月|这|打扮|估计|得|1|车|精神病
十月份|的|武汉|穿|棉服</comments>