<source>iPhone 7 Plus</source>
<title></title>
<time>2020-3-26 23:47</time>
<url>https://weibo.com/1496883514/IArW8bpKR</url>


<text>凯雷|2020|3|26|23|38|来自|iPhone|7|Plus|已|编辑|上海|申通|英国|儿子|与|杭州|西湖|美国|女儿|事件|一样|官员|和|老板|都|能|易如反掌|拿出|文件|但|面对|基层政权|组织|和|居民|都|哑口无言|上海|当|克服困难|效仿|浙江|留学生|一律|集中|隔离|否则|难保|城市|安全|基层|疫漶|无穷|黄埔|一投|根据|上海|相关|规定|该|人|核酸|检测|阴性|官方|转运|空置房|安置|居家|隔离|符合|规程|Alice|的|小白桃|抱歉|小区|里|20|号|以来|陆续|来|了|各个|国家|的|留学生|在|居家|隔离|的|杭州|这次|不|跟着|省里|走|/|/|唐离|不离|i|居委|书记|警察|面对|群众|质问|避而不答|否则|当时|就|可以|解决|了|吖|为啥|现在|还|传|网上|/|/|123321|嗨|一人|一户|是|更|符合|居家|隔离|的|政策|与|精神|的|上海|一直|允许|居家|隔离|并且|境外|回来|都|已经|经|核酸|阴性|才|回|社区|居家|隔离|不|知道|要|喷|啥|O|网页|链接</text>
<comments>不少|留学生|的|家长|都|是|官员|政策|的|制定|不能|影响|孩子|回家
他们|一天天|的|工作|是|研究|法律法规|的|漏洞|以|自己|用|还是|故意|定制|有|漏洞|的|法律法规|方便|自己|用
申通|事件|就|暴露|了|右边|这些|人|不|接地|气|有|本事|就|事先|对接|好|居委会|否则|右边|的|都|是|些|忽悠|/|九峰|阿伟|凯雷|老师|上海|是|居家|隔离|优先|于|集中|隔离|社会|各方|为|居家|隔离|付出|了|不少|直至|今日|居家|隔离|并|没有|造成|疫情|的|传播|和|扩散|整个|过程|有序|机场|检疫|送|社区|都|是|专门|大巴|送
如果|黄|某某|隔离|手续|合法|合规|那大|可以|在|达安|隔壁|14|天|其他|居民|也|无权|把|他|赶走|那|为什么|昨晚|把|他|带|离|出去|了|不是|都|合规|吗
西湖|与|崇明|都|没有|做到|—|崇明|更|特别|的|是|该|留学生|不是|小区|居民|也|不是|户主|也|不|告知|/|上海浦东|周渡|消防|中队|退伍|老兵|问题|是|事先|知道|不|居民|都|不|知道|隔离|就|该|一|开始|贴条|加锁|和|报警器|探头|和|专人|看护|貌似|看|视频|没有|吧|所以|让|周围|群众|愤怒|这是|症结所在
我们|小区|今天|也|有|一个|英国|回来|要|居家|隔离|的|傍晚|门卫|防护服|又|穿|上|了|等|着|对接|业主|们|都|担心|还|在|讨论|据说|今天|刚回|上海|二次|检查|阴性|专门|送过来|和|居委|物业|对接
又|来|一个|法条|党|申通|事件|就|暴露|了|右边|这些|人|不|接地|气|有|本事|就|事先|对接|好|居委会|否则|右边|这些|人|不是|坏人|但|都|是|些|忽悠|根本|沒有|做好|落地|/|春末|夏末|上海|核酸|阴性|可以|居家|隔离|居家|隔离|由|专车|送达|小区|居委|专人|来接|这是|居家|隔离|正常|流程
唐离|不离|i|居委|书记|警察|面对|群众|质问|避而不答|否则|当时|就|可以|解决|了|吖|为啥|现在|还|传|网上|/|/|123321|嗨|一人|一户|是|更|符合|居家|隔离|的|政策|与|精神|的|上海|一直|允许|居家|隔离|并且|境外|回来|都|已经|经|核酸|阴性
/|黄埔|一投|根据|上海|相关|规定|该|人|核酸|检测|阴性|官方|转运|空置房|安置|居家|隔离|符合|规程
只能|说|官员|好|有钱|孩子|都|送到|国外
我|朋友|女儿|纽约大学|前天|回来|的|直接|集中|隔离|了|父母|不能|探望|不能|送|东西|回国|三天|见|不到|女儿|这些|当官|的|特权|哪里|来|的|革职|法办
难道|不|知道|钱和权|是|通行证|吗|没|必要|装不懂
搞|特权|难道|检测|阴性|都|可以|居家|隔离|吗|境外|输入|都|是|被|你们|搞|特权|才|爆发|的
没权|没钱|寸步难行|有钱|有权|横行天下
刚|看到|美国|一个|医生|感染|新冠|病毒|居家|隔离|孤独|死去|而|他|死|的|时候|他|四岁|的|女儿|就|在|他|身边|看|的|真的|很|难受|什么|都|比|不过|健康|拜托|上海|的|官员|富豪|们|立即|对|海外|入境|人员|一律|集中|隔离|老百姓|不会|反对|你们|的|老婆|情人|子女|回国|避难|但|你们|也|必须|保证|老百姓|的|生命安全|不要|再|制造|太多|的|人间|惨剧|了
洋女婿|不|也|居家|隔离|怎么|不|讲|呢
最好|是|集中|隔离|集中|隔离
这样|的|事|和|医护人员|奔赴|一线|不计|生死|的|新闻|比|起来|真让人|心痛|然后|又|有|基层|伺候|外国人|还|以此为荣|这|都|什么|事|啊|危机|还|未|解除|就|这么|多|幺|蛾子
洋奴|们|总是|跪|的|有模有样|就算|是|洋|奴才|在|国人|面前|还是|显得|高人一等|的|存在
疫情|是|个|照妖镜|疫情|是|个|检验员|疫情|是|个|曝光|台
确实|不该|在|这个|时候|透支|政府|的|公信力|既然|出|了|规定|就|应该|彻底|执行|疫情|开始|见惯|了|武汉|官员|的|各种|骚|操作|看来|哪|都|是|一样|的
居家|隔离|也|可以|必须|有人|出来|担保|万一|确诊|了|担保人|赔偿|受|牵连|的|人|的|损失|开除|职务|如果|牵扯|命案|人|以命|偿命
再|搜索|一下|名下|多少|房产|怕|惹祸|上升
上海|今天|不是|已|公告|执行|隔离|了|吗|？
居家|隔离|将|漏洞百出|后患无穷|...
特权阶层|集体|秀
崇明|在|上海|远郊|老百姓|刚刚|碰到|境外|居家|隔离|所以|闹意见|事实上|市区|稍微|好点|的|小区|居家|隔离|很多|的|符合|政策|就是|可以|的|除非|政府|出台|一刀切|目前|政策|下|确实|没|毛病
话题|申通|地铁|送|你|到|家|顶起
上海|核酸|阴性|可以|居家|隔离|居家|隔离|由|专车|送达|小区|居委|专人|来接|这是|居家|隔离|正常|流程
这次|可以|测底|普查|官员|子女|了</comments>