<source>iPhone 7 Plus</source>
<title>#意大利人答为何不带口罩#：大多认为是大流感，“健康人没事”</title>
<time>2020-3-22 22:14</time>
<url>https://weibo.com/1496883514/IzPG3qosW</url>


<text>凯雷|2020|3|22|22|14|来自|iPhone|7|Plus|已|编辑|老百姓|分不清|哪国|都|一样|总以|是|流感|或|肺炎|1|月份|我|告诉|身边|朋友|这|是|像|SARS|告诉|韩国|朋友|这|是|像|MERS|他们|就|一下子|警醒|否则|白说|媒体|的|意义|是|预警|命名|的|意义|是|警示|本质|是|一种|唤醒|和|行动|否则|没用|意大利|完|了|意大利人|答|为何|不带|口罩|大多|认为|是|大|流感|健康人|没事|3|月|21|日|意大利|新冠|肺炎|累计|确诊|数量|已经|达到|53578|例|3|月|10|日|宣布|封国后|民众|擅自|外出|聚集|成为|政府|管理|的|难题|之一|疫情|爆发|前夕|梨|视频|拍客|采访|了|普通|民众|在|他们|的|认知|中|新冠|肺炎|并|不|严重|O|网页|链接</text>
<comments>媒体|的|意义|是|预警|命名|的|意义|是|警示|本质|是|一种|唤醒|和|行动|否则|没用|意大利|完|了
我|11|月|在|武汉|朋友|就|微信|我|你|还|不|离开|武汉|据说|武汉|有|流感|12|月底|看到|一条|消息|武汉|肺炎|严重|有|医生|感染|一般|民间|传|的|我|都|是|很|相信|的
还|想|让|咱们|医护人员|上|一线|ICU|我|看|这事|做|不得|没有|群众|基础|再|厉害|的|尖兵|也|不|可能|取得|全面|胜利
中国|03|年|吃|过|SARS|的|亏|所以|开始|报|和|SARS|近亲|的|呼吸道|传染病|国人|的|警惕性|一下|提高|到|空前|的|警觉|高度
老百姓|分不清|哪国|都|一样|总以|是|流感|或|肺炎|1|月份|我|告诉|身边|朋友|这是|SARS|告诉|韩国|朋友|这是|MERS|他们|就|一下子|警醒
有|道理
哈哈哈|哈哈
美国|也|是|一样|不见棺材不掉泪|虽然|政府|现在|也|让|在家|待|着|了|但|还是|有人|举行|婚礼|外出|游玩|我们|这里|已|通知|军队|做好|准备|随时|可能|封城|据说|医院|里|其他|科室|不|直接|接触|新冠|病人|的|医护人员|都|不让|戴|口罩|这种|认知|一时半会儿|改不|过来|真让人|忧心
什么|叫|意大利|完|了|之前|是|低估|了|没|做好|准备|工作|现在|意大利|已经|很|努力|的|在|做|了|不要|发|这种|没有|意义|的话|了
所以|李医生|说|萨斯|是|起到|警示|作用|的
他们|还|不|知道|这个|病|的|后遗症|是|什么|呢|以为|好|了|就|没事|了|真是|天|真的|要命|即使|当时|治疗|好|了|肺部|的|白斑|和|粘液|还是|需要|很|久|才能|消失|每天|白天|晚上|会|不由自主|的|干咳
不是|老百姓|分不清|媒体|告诉|他们|就是|流感|2|月|26|号|意大利|大区|主席|还|说|不|严重|不用|戴|口罩
主要|不是|接触|传播|啊|飞沫|传播|才|是|主要|哎|本末倒置
是不是|听信|了|美国|错误|的|预判|意大利|疫情
凯总|加油|/|凯雷|媒体|的|意义|是|预警|命名|的|意义|是|警示|本质|是|一种|唤醒|和|行动|否则|没用|意大利|完|了
我|觉得|意大利|权威|媒体|或者|医学界|权威人士|有|必要|在|意大利|人们|都|看|得到|的|媒体|上|科普|新冠|病毒|的|传染性|之强|要|让|他们|意识|到|这种|病毒|的|厉害|程度|所有人|都|可能|被|传染|只有|尽量|阻断|传染源|才能|确保安全
说|SARS|的|不是|都|被|训诫|了|吗
这|真的|是|群体|智商|的|硬伤|了
说|的|好|啊|早|预警|人们|就|会|自觉|的|保护|自己
上帝|总是|想先|见到|一些|不够|认真|生活|的|人
科普|的|不|到位
我|意识|到|新冠|严重性|来|看到|有人|拿斯坦|索姆来|举例
看|推特|就|很|显现|凯凯|这个|观点|感觉|外国人|儿们|对|这个|病毒|了解|很少
一天|五六千|太|吓人|了
中国|疾控中心|的|领导|极力|反对|用|萨斯|命名
命名|的|意义|是|警示|也|是|语言|的|艺术|和|意义
现在|都|不敢|用|SARS|cov2|这个|称呼
就|你|这|嗓门|有用吗|特朗普|的|嗓门|比|你|大多|了
这是|sars|plus
意大利|太|不听话</comments>