<source>iPhone 7 Plus</source>
<title></title>
<time>2020-3-22 21:39</time>
<url>https://weibo.com/1496883514/IzPrIzH8t</url>


<text>凯雷|2020|3|22|21|39|来自|iPhone|7|Plus|已|编辑|美国国务院|发言人|奥尔塔|格斯|接受|凤凰卫视|独家|专访|美国|总统|特朗普|把|新冠|病毒|称为|中国|病毒|绝非|针对|中国|人民|也|不|具有|政治|目的|奥尔塔|格斯|在|采访|中|并|不|否认|中国|向|美国|进行|有|有|意义|的|新冠|疫情|数据|分享|她|表示|中|美|外交政策|并非|零|和|游戏|王冰|汝|美国|疫情|这是|一次|特别|的|采访|是|我|第一次|没有|面对面|而是|通过|视频|采访|美国政府|高级官员|新冠|疫情|来势汹汹|美国国务院|已经|有|多|人|确诊|於|是|美国|发言人|决定|与|记者|们|保持|Social|Distance|当下|最|流行|的|一个|词|社交|距离|基本上|该|问|的|问题|都|问|了|比如|美国|说好|的|一|亿美元|呢|中国|驻美|记者|去留|中国|病毒|提法|中国|与|美国|的|数据|分享|等等|美国国务院|发言人|奥尔塔|格斯|也|有问必答|采访|摘要|写|在|这里|视频|稍后|问|蓬佩奥|国务卿|说|中国|阻碍|了|美国|对|新冠|疫情|的|应对|答|中国|不仅|阻碍|了|美国|还|让|世界|行动迟缓|了|问|但是|美国政府|传递|出|不同|的|信息|美国|国立|过敏|和|传染病|研究所|所长|费契|医生|甚至|连|美国|总统|特朗普|都|称赞|中国|的|数据|分享|你|同意|他们|的|观点|吗|答|我|认为|由|特朗普|总统|领导|的|美国政府|在|这|一点|上|是|完全一致|的|记者|们|总是|做|零|和|游戏|但是|外交|并非|零|和|游戏|我们|在|研究|新冠|病毒|来源|时|我们|需要|完全|的|透明|和|责任|不|应该|相互指责|而是|去|探索|了解|我们|如何|可以|防止|未来|大规模|流行病|侵害|世界|问|但是|我们|看到|的|是|美国政府|在|指责|他人|昨天|特朗普|总统|故意|把|讲稿|上新冠|病毒|替换成|中国|病毒|答|这|并非|是|在|进行|指责|这是|一个|事实|中国|由|特殊|的|责任|帮助|阻止|从|来源于|中国|的|大|流行病|我们|支持|中国|人民|我们|绝对|不是|指责|中国|人民|我们|有|几百万|华人|我们|在|全世界|与|中国|人民|合作|还有|很多|机构|和|私营|组织|我们|还|看到|这次|疫情|中|中国|的|医生|是|真正|的|英雄|问|特朗普|政府|把|新冠|成为|中国|病毒|是不是|有|政治|考虑|今年|正好|是|大选年|答|我|已经|解释|过|了|否认|问|随着|新冠|疫情|在|中国|逐步|好转|美国|是否|会|考虑|尽快|重新|恢复|签证|业务|答|目前|我们|仍然|要求|驻华使馆|人员|离开|中国|这|意味着|只有|很少|很少|的|核心|员工|留在|中国|当然|未来|什么|时候|我们|能够|恢复|签证|服务|我们|能够|让|使馆|的|人员配备|回到|正常|国务卿|蓬佩奥|当然|会|宣布|我们|会|通知|所有人|问|还|留在|美国|的|其他|中国|记者|是否|应该|担心|美国国务院|会|采取|进一步|报复|措施|答|我|完全|不|同意|你|问题|的|前提|这|不能|相提并论|我们|没有|采取|针对|中国|记者|的|任何|报复|措施|我们|认为|现在|比|过去|任何|时候|都|需要|透明度|事实上|现在|应该|是|全世界|团结|以来|拿出|透明度|共同|对抗|全球|大|流行病|的|时候|那|你|会|采取|进一步|措施|回应|吗|我们|不会|提前|透露|下|一步|行动|问|中国外交部|说|从未|收到|过|美方|承诺|的|资金|或|物资|援助|请问|美方|承诺|的|一|亿美元|新冠|疫情|援助|目前|落实|了|吗|答|我|需要|核实|一下|据我所知|目前|落实|了|6000|万|L|王冰|汝|的|微博|视频|181|万次|播放|2|42</text>
<comments>那个|英超|歌曲|会|删评|控评|十有八九|是|史力|西
中国|给|世界|争取|了|一个月|的|时间|来|准备|应付|这个|面貌|未知|的|病毒|换回来|的|还是|傲慢|和|偏见|去|吧|美利坚|上帝|需要|美国|人
虚伪|的|家伙
新冠|肺炎|俗称|特朗普|病毒|🦠|发源|于|美国
不|对|啊|我|个人|已经|给|你|吗|美国|捐赠|100|亿|已经|落实|9000|亿|了|钱|哪|去|了
想|把|中国|人民|拉到|它|的|一方|痴心妄想
疯|了|一样|的|国家|疯狗|一样|的|总统|理他|做|甚
6000|万|我|一分|都|没收|到
记者|为什么|特别|关心|签证|呢|目前|的|形势|下|美国|几乎|不|可能|在|两个|月|内|恢复正常|谁|还|急|着|要|去|疫区
巨婴|闯祸|国家|帮|擦屁股
这个|发言人|不是|刚|舔|完|中国|吗|美利坚|驰名|变脸|谎话|连篇
假话|连篇|的|家伙
美国|是|一个|实用主义|国家|现在|急需|医疗|物资|特大|嘴|此时|发言|不利于|美国|获得|医疗|物资
去|见|你们|的|上帝|吧
美利坚|被|这帮|政客|变成| |人间|渣
一个|说辞|一个|动作
主要|为了|甩锅
看|完|这个|采访|只能|说|这位|发言人|出来|接受|采访|一点|都|不能缓和|中美关系|跟川普|一丘之貉|他们|自己|反应|慢|还是|中国|的|锅|谈|什么|合作|我|觉得|中国|跟|现任|美国政府|没有|合作|的|基础|与|可能|合作|就要|被|甩|锅|吧
谁|塔玛信|啊|不|针对|中国|人民|没有|政治|目的|扯|他|妈|犊子
楼下|那个|英超|歌曲|fire|用户|你|激动|个|毛|啊|你|爹|特朗普|早就|说|了|不|就是|个|流感|至于|嘛|嗯|今年|流感|死|掉|的|两万|美国|人|里面|有|多少|是|新冠|肺炎|你|知道|啊|前|几年|美国|的|h1n1|美国|死|了|几万人|你|知道|吗|0|号|病人|在|哪里|？|来来来|你|厉害|你|给|我们|中国|人|一个|交代|不说|清楚|算|什么|地球|人
凯总|这篇|博文|想|告诉|中国|人|什么
当|疫情|在|中国|爆发|时|成天|批评|中国|限制|人权|嚷|着|制造业|回流|等|中国|控制|了|疫情|而|自己|后院|着火|赶紧|粉饰太平|愚弄|大众|病毒|是|流感|没|必要|惊慌|再|到|后来|金融市场|狂跌|全国|压不住|疫情|开始|甩锅|指责|中国|隐瞒|疫情|在|民间|制造舆论|引起|仇恨|和|矛盾|转移|大众|视线|为了|连任|川普|打开|了|潘多拉|魔盒
记者|的|提问|没|水平|照着|自己|提纲|问
我们|没有|针对|中国|人|......|什么|时候|政府|和|人民|是|可以|分开|来说|的|如果|美国|攻打|一个|国家|的|政府|难道|只|轰炸|总统府|吗
这|回答|可真|虚伪
所以|我们|平时|说|的|美帝国主义|和|还有|美国|流氓|也|不是|针对|美国
对|不|针对|中国|人民|是|针对|人民币|不要脸|的|东西|呸
这篇|博文|是|在|完成|总部|任务|吧|凯总|也|有|怕|的|人|文字|中|充满|了|敬畏|写|的|不赖|是|真实|感悟
一边|想|让|大夫|救命|一边|又|不想|让|大夫|赚钱|这|不|就是|土匪|吗
回复|凯雷|的|表态|请|看看|我前|一个|微博</comments>