<source>微博 weibo.com</source>
<title>#北京餐饮暂停婚宴酒席等活动#</title>
<time>2020-6-15 16:04</time>
<url>https://weibo.com/1618051664/J6L7JmlcA</url>


<text>头条新闻|2020|6|15|16|04|来自|微博|weibo|com|北京|餐饮|暂停|婚宴|酒席|等|活动|北京|疫情|为|加强|商业|企业|疫情|防控|措施|北京市|商务局|近日|向|各大|商业|企业|发布|紧急通知|要求|按照|二级|响应|防控|措施|要求|抓好|疫情|防控|工作|餐饮企业|暂停|举办|婚宴|酒席|等|群体性|聚餐|活动|根据|市|商务局|发布|的|关于|从严|从|紧|抓好|商业|服务业|疫情|防控|工作|的|紧急通知|各|企业|要|在|确保|落实|落细|防疫|措施|的|前提|下|有序|开展|经营|活动|餐饮企业|暂停|举办|婚宴|酒席|等|群体性|聚餐|活动|控制|经营场所|人员|密度|防止|人群|聚集|严格|落实|口罩|测体温|消杀|通风|核验|健康|宝及|扫码|登记|等|措施|同时|企业|要|坚决|杜绝|带病|上岗|近|14|天到|过|新|发地|批发市场|的|人员|要|立即|安排|其|就近|进行|核酸|检测|通知|要求|各区|商务|部门|要|主动|协调|城管|执法|市场监管|等|部门|有|重点|地|加强|农产品|批发市场|菜市场|店|餐馆|超市|生鲜|果蔬|等|场所|的|执法检查|督促|企业|落实|疫情|防控|主体|责任|以及|新|发地|批发市场|关联|人员|的|管理|对|存在|问题|的|企业|督促|其|立即|整改|对|重复|出现|问题|的|企业|要|加大|约|谈|和|公示|力度|此外|企业|线下|各种|仪式|发布会|现场|展卖|等易|造成|人员|聚集|的|活动|取消|或|推迟|记者|了解|到|这份|通知|已|下发|到|各|企业|通知|要求|各|单位|严格|落实|四方|责任|加强|组织|领导|加大|防控|力度|对|新|发地|批发市场|发生|的|疫情|要|引以为戒|举一反三|按照|二级|响应|防控|措施|要求|迅速|调整|完善|防控|工作|方案|预案|科学|精准|有效|地|抓好|疫情|防控|工作|北京日报</text>
<comments>可怜|了|一些|私人企业|了|今年|估计|难熬
严格|一点|是|对|的|不能|大意
安全|第一
也|要|考虑一下|民生|啊|一刀切|是|安全|可是|代价|谁|来|承担
天呐|准备|好|的|食材|又|扔|了|今年|太惨|了
前段时间|办|了|婚宴|酒席|的|赶上|了|车|🙏|🙏|酒店|又|得|亏了|坚持|一下|吧|这|段时间|严防|严控|才能|更|快|恢复
餐饮|已经|比|电影院|好多|影院|真是|遥遥无期
今年|靠|地摊|经济|自给自足|吧
我|一个|同学|是|真的|惨|在|北京|本来|准备|年初|办|婚礼|疫情|了|然后|改到|了|6|月底|又|严重|了
支持|呀|不|聚集|避免|感染|希望|早日|清零
河北|的|还|能|办|吗
其实|这|段时间|大家|都|松懈|了
又|是|一个|至暗|时刻|一起|加油|共同|面对
害|才|降到|三级|这|又|重启|二级|了
哈|你们|之前|已经|可以|办|婚宴|了|？
北京|餐饮|暂停|婚宴|酒席|等|活动|北京|疫情
不光|北京|别的|省市|应该|也|先|暂停
很多|饭店|早就|取消|安全|就餐|距离|其实|放开|的|时候|更|应该|注意安全|距离|商家|做|的|越|安全|社会|才|会|越|安全|经营|环境|才|会|越来越|好
作为|婚礼|行业|工作人员|刚刚|看到|希望|又|希望|疫情|早日|过去|一切|恢复|如常
安全|第一|大家|做好|防范
希望|疫情|不要|再|扩散
餐饮业|太惨|了|今年|啥时候|能|正常
交|的|定金|能|全额|退款|不|不想|办|了
延期|到|十月份|的|婚礼|还|能|办|吗|🙊|感觉|又|没戏
第一|时间|是|追踪|市场|外漏|人员|像|那个|浙江|的|都|已经|跑|回老家|了
今年|诸事|不宜|别|结婚|也|别|离婚|别|创业|也|别|辞职|一切|为了|保命
做|的|对
我们|领导|现在|还|怂恿|我们|聚餐|唱|k
嗯
酒店|刚想|活过来|又|被|掐死|了|五|这些|星级|已经|摆摊|送|外卖|好几个|月|了</comments>