<source>微博 weibo.com</source>
<title>北京市经信局：#路过中高风险地区健康码变色不准确#</title>
<time>2020-6-24 14:22</time>
<url>https://weibo.com/1618051664/J87j08xKu</url>


<text>头条新闻|2020|6|24|14|22|来自|微博|weibo|com|已|编辑|北京市|经信局|路过|中|高风险|地区|健康|码|变色|不|准确|北京|疫情|近日|有|市民|提出|疑问|如果|路过|北京|中|高风险|地区|北京|健康|宝|的|健康|码会|变色|吗|记者|从|北京市|经信局|获悉|健康|宝|不|采集|个人|位置|信息|目前|是|根据|权威部门|数据|进行|健康|状态|的|标识|网上|所|称|路过|中|高风险|地区|就|变色|是|不|准确|的|北京市|经信局|相关|负责人|解释|称|健康|宝|不|采集|个人|位置|信息|根据|卫生|健康|部门|提供|的|共享|数据|确诊|疑似|密接|无症状|感染|人员|等|四类|人员|呈现|集中|观察|红色|码|状态|如果|近期|去过|新发|地|等|高风险|场所|或者|和|相关|人员|有过|密切接触|这部分|人员|核查|后|纳入|社区|管理|被|赋予|居家|观察|的|黄色|码|状态|快到|端午节|了|有|市民|想|了解|如果|自己|去|了|外地|回京|后|健康|码|是否|会|变色|记者|了解|到|受|疫情|影响|北京|目前|严格|进出|京|管理|提倡|市民|非必要|不|出京|依然|有|需要|出京|的|市民|建议|提前|了解|出京|所|需|证明|并|提前|了解|目的地|疫情|防控|要求|市经|信局|相关|负责人|称|对于|确有|出京|需求|的|人员|健康|宝|链接|国家|政务|服务平台|核验|近|14|日|行程|使用者|从|外地|回京|健康|宝会|有|弹窗|提示|引导|使用者|到|国家|政务|服务平台|做|行程|核验|只要|没有|到|过|中|高风险|地区|就|没有|问题|新|京报</text>
<comments>这个|码|细纠|的话|其实|挺蠢|的|然而|也|没什么|办法
很|准确|啊|路过|就|会|变色|才|不管|你|去|没|去过|新|发地|市场|里
路过|变色|不是|很|正确|吗|路过|也|有|风险|啊
建议|端午|假期|减少|出门
为啥|我|在家|坐|着|昨天|变紫|今天|变橙
你|可|拉倒|吧
哦
家住|在|高风险|地区|依然|还是|绿色|的
说|的|是|不|准确|但|没|说|不|变色
看成|路过|中|高风险|地区|面不改色
我|就|在|中|风险|地区|住|着|根本|就|不|变色|我|同事|同|一栋|楼|发现|疑似|患者|他们|小区|是|高风险|都|毫无|影响
不|变色|才|有|问题
怎么|才能|变色|在|高风险|地区|上班|好|几天|了|也|没变
然而|我家|人|开车|在|京开|堵|了|车|就|被|大|数据|拉去|做|核酸|检查|是|阴性|但|还是|黄色|居家|观察|14|天|甚至|出|结果|前两天|变成|红色|集中|隔离|找|谁|说理|都|没用|打电话|之后|又|给|变|了
北京|的|还是|别|出来|了|吧
在家|呆|着|吧|别|乱跑|了|为了|自己|和|同胞
河北|到|天津|路过|北京|可以|正常|通行|吗
想|知道|国家|政务|服务平台|是|干|啥|的|为啥|会|平白无故|给|激活
疫情|会|通过|蚊子|传播|么
面不改色|其实|也|对|不是|还有|下|一句|心不跳|么|瓦当|看成|路过|中|高风险|地区|面不改色
不要|随便|转发|啊|🙈|真的|有|好多|人|只是|路过|就|变色|了
为什么|我|的|健康|宝|变色|了
能|不|出去|就|不|出去
北京市|经信局|路过|中|高风险|地区|健康|码|变色|不|准确|北京|疫情|近日|有|市民|提出|疑问|如果|路过|北京|中|高风险|地区|北京|健康|宝|的|健康|码会|变色|吗|记者|从|北京市|经信局|获悉|健康|宝|不|采集|个人|位置|信息|网上|所|称|路过|中|高风险|地区|就|变色|是|不|准确|的|职业|体验|师|lucy|hu|的|问答|lucy|hu|#
路过|就|会|变色|这个|新闻|好|假|哦
是|不|准确|不是|不|监控|哦</comments>