<source>专业版微博平台</source>
<title>特朗普现场证明能单手喝水 周围人群发出雷鸣般的欢呼声</title>
<time>2020-6-21 09:47</time>
<url>https://weibo.com/2028810631/J7DdIyiwM</url>


<text>新浪|新闻|2020|6|21|09|47|来自|专业版|微博|平台|特朗普|现场|证明|能|单手|喝水|周围|人群|发出|雷鸣般|的|欢呼声|当地|时间|6|月|20|日|特朗普|在|俄克拉何马州|塔尔|萨市|举行|竞选|集会|集会|开始|前|几小时|特朗普|竞选|团队|6|人新冠|病毒检测|阳性|在|当天|由于|出席|集会|的|人数|低于|预期|特朗普|竞选|团队|取消|了|在|场外|的|露天|讲话|特朗普|现场|展示|能|用|单手|举起|杯子|喝水|周围|人群|发出|雷鸣般|的|欢呼声|此前|特朗普|在|西点军校|对|毕业生|致词|时|被|拍|到|无法|单|用|右手|把|水杯|送到|嘴边|喝水|被|媒体|怀疑|健康|出|了|问题|L|环|视频|的|微博|视频</text>
<comments>单手|喝水|这|难度|也|太|高|了|吧
顿时|感觉|媒体|对|他|的|描述|已经|很|克制|了
历害|所以|大小便|目前|还|能|自理
这|就|高潮|了|我|不用|手扶|就|能|让|丁丁|尿到|马桶|里|岂|不是|绝世|壮举
你|要|这样|说|的话|我|也|能|当|总统
好|厉害|👍|他|是|怎么|做到|的|居然|用|一个|手|就|可以|喝水|了
天|哪|美国|总统|竟然|能|单手|喝水|了|太|厉害|了
可能|是|大脑|里|有|一根|筋|接错|了
单手|喝水|难道|米|国人|都|是|双手|喝|的|吗|怪不得|那么|多人|中标|看|你|特|总|身体|多好|都|中标|就|他|不|中
厉害|厉害|👍|这|是|我|见|过|最|精彩|是|杂技|了|🤹|‍|♂|️
媒体|我|已经|给|你|足够|的|面子|了
哇塞|他|竟然|能|单手|喝水|这|可不是|一般|人能|做到|的|事情|他|的|身体|太好了
几个|意思
这个|扔|的|动作|就|很|灵性
单手|举杯|喝水|川粉|发出|雷鸣般|的|欢呼声|这|确定|不是|神经病|在|精神病院|里|给|病患|演讲|？
您|居然|能|单手|喝水|您|太|厉害|了|我服|您|了
特朗普|我|还|能|呼吸
证明|了|个|寂寞
出来|之前|打|了|一针
厉害|老特|小可爱
喝|的|恒河|水吧
太|厉害|了|现在|不会|是|连|上|厕所|这么|高难度|的|动作|都|能|自己|完成|了|吧|美国|复兴|指日可待|了
晕|了|这太|牛皮|了
他|真是|个|吉祥物|啊|他
袖子|里|是|啥|机械|臂
明天|标题|渐冻症|或|可|治愈|这位|名人|或成|第一|受益者
真|厉害
怎么样|才能|证明|川普|不是|脑残
没想到|有|一天|能|看到|一国|总统|为了|证明|能|单手|喝水|而|表演|是|搞笑|艺人|么|真是|幼稚
美国|总统|示范|如何|单手|喝水</comments>