<source>iPhone 7 Plus</source>
<title>尼日利亚籍新冠肺炎患者打伤护士 警方刑事立案调查</title>
<time>2020-4-2 02:37</time>
<url>https://weibo.com/1496883514/IBnBPEjOz</url>


<text>凯雷|2020|4|2|02|27|来自|iPhone|7|Plus|性质|恶劣|超出|想像|支持|广东|警方|依法严办|并|追究|医院|主任|渎职|尼日利亚|籍|新冠|肺炎|患者|打伤|护士|警方|刑事|立案|调查|据|广州|公安|广州市公安局|新闻|办公室|今天|4|月|2|日|凌晨|0|时|40|分|通报|4|月|1|日|7|时|28|分许|广州市公安局|110|台|接到|报警|称市|第八|人民|医院|嘉禾|院区|住院部|一楼|隔离|病区|以下|简称|市八|医院|有|一名|外籍|新冠|肺炎|确诊|患者|不|配合|治疗|并|将|一|女护士|打伤|广州|白云|警方|立即|派员|到场|处置|经|初步|调查|当天|7|时|20|分许|市八|医院|隔离|病区|女护士|汪某|请|一|外籍|新冠|肺炎|确诊|患者|OKONKWONWOYE|CHIKA|PATRICK|男|47|岁|尼日利亚|籍|抽血|检查|该|患者|不予理睬|还|紧随其后|试图|强行|走出|隔离病房|护士|见状|立即|将|其|阻拦|被|其|推倒|在|地|殴打|并|咬伤|脸部|经|法医|检查|护士|汪某|面部|脖颈|处|以及|腰部|都|发现|损伤|鉴定|为|轻微伤|该|外籍|确诊|患者|3|月|20|日自|境外|入境|广州|接受|新冠|病毒|核酸|检测|呈|阳性|23|日|被|送市|八|医院|进行|隔离|治疗|目前|其|核酸|检测|仍为|阳性|目前|该|医院|已|加强|内部|隔离区|安保|力量|同时|广州|警方|已立|刑事案件|对|此事|进行|调查|并|进一步|加强|了|对|医院|内部|及|周边|的|安保|工作|涉案|嫌疑人|目前|正在|警方|监管|下|隔离|治疗|待|其|治疗|结束|警方|将|立即|对|其|采取|刑事|强制措施|并|依据|中华人民共和国|传染病|防治法|刑法|外国人|入境|出境|管理法|等|法律法规|坚决|依法|严肃处理|L|虫子|医僧|的|微博|视频</text>
<comments>我|的|天|我|好|心疼|这个|小姑娘|不过|说|起来|凯总|你|咋|还|没|睡
自己|呈|阳性|还|咬伤|护士|这是|故意犯罪|不|严惩|相关|人员|不足以|平民愤
把|那个|不让|宣传|的|主任|拉|出来
罚款|驱逐出境|追究|相关|人员|责任|基本操作|必须|的
为什么|外国人|可以|胡作非为|不|遵守|我国|制度|还要|受到|庇护
医院|是|怕|评级|评不上|吧|不|通报|洋人|错误|的|威风|总|要|我们|及早|浇灭|除了|我们|自己|努力|变得|强大|起来|我们|的|态度|要|强硬|要|宣扬|社会|正义|的|精神|给|外国人|吧|必须|让|他们|知道|他们|的|粗暴|的|行为|遭受|的|惩罚|让|他们|自己|慢慢|进行|自我教育|帮|他们|治病|还|不|感恩|是不是|又|拿|人权|说事|了|？|要|自由|的话|就让|他|滚出|中国
物极必反|民族主义|已经|崛起
博主|不|方便|直接|点名|那|我|我|替|你|点名|吧|广州市|第八|人民|医院|ICU|重症|传染病|科室|主任|邓|西龙|邓大|主任|之前|广州日报|还|报道|她|是|钢铁|女侠|我|真特|喵|了|个|呸|呸|呸|的|就是|个|欺软怕硬|自私自利|无|任何|民族气节|丢|尽|国家|尊严|的|辣鸡
治|什么|治|直接|驱逐出境|哪儿|来|的|回|哪儿|去
是|时候|遣返|驱逐|那些|非洲|黑人|了
我们|对|海外|归来|的|华人|都|可以|这么|严格|对|外国人|也|一样|严格|不|可以|有优|国民待遇
把|人交|出来|我|代表|宇宙|消灭|他|气死我了|大半夜|的|看到|这个|请|先|按照|中国|的|法律法规|法办|他|在|驱逐出境|永不|得入|中国
明知|有|传染病|还|伤人|已经|属于|故意杀人罪|必须|依法|判处
对|请|严办|腰|挺直|不要|软
卑鄙|是|卑鄙|者|的|通行证|小姑娘|闭眼|哭|的|那一刻|世界|都|要|崩塌|了
政府|请|善待|自己|的|国民|为何|要灭|自己|的|士气|扬|他人|的|威风
多|关心|一下|北京|坦桑尼亚|那位|吧|毕竟|你|离|得|近
当时|没有|男|大夫|没有|保安|吗|应该|先|狠狠|的|揍|一顿|在|报警|处理
得|狂犬病毒|咬人|对|咬|人|的|黑狗|赶紧|处以|极刑
坐等|公安局|处理结果
一定|要|严惩
洋垃圾
必须|严办|主任|让|他|去|尼日利亚|一辈子|不得|回来
哪个|王八|但|的|政策|一群|黑猩猩|放入|国门
，|这是|中国|现在|史|的|耻辱
广州|护士|被|外国人|攻击|太过分|了
希望|中国|执法人员|能够|挺直|腰杆|处理|这个|洋垃圾
不|应为|🐶|开|的|门|一直|敞开|着
就|想|看看|究竟|怎么|严办
这个|还|挺|麻烦|必须|把|他治好|了|才能|驱逐出境</comments>