<source>iPhone 7 Plus</source>
<title></title>
<time>2020-4-5 21:48</time>
<url>https://weibo.com/1496883514/IBXuzAa3h</url>


<text>凯雷|2020|4|5|21|48|来自|iPhone|7|Plus|没有|对比|就|没有|伤害|欧美国家|在|疫情|面前|如此|糟糕|答案|可能|是|这样|综合|比较|1|月份|以来|海内外|疫情|中|的|表现|可能|找到|答案|欧美国家|拥有|高超|的|医疗|技术|但是|公共|卫生防疫|能力|却|不|一定|高|2|月份|疫情|早|欧洲|爆发|尤其|是|意大利|和|西班牙|成为|欧洲|疫情|最为|严重|的|国家|意大利|的|确诊|人数|和|死亡|人数|曾经|一度|都|是|世界|第一位|而|进入|到|3|月份|特别|是|3|月|10|日|以后|美国|疫情|开始|集中|爆发|先后|经历|确诊|人数|破千|破万|破|10|万|如今|已经|突破|20|万|大关|而|曾经|特朗普|引以为傲|的|美国|低|死亡率|如今|也|已经|突破|5000|人|欧美国家|都|是|发达|的|资本主义|国家|特别|是|美国|是|世界|第一|强国|拥有|高超|的|医疗|技术|但是|为何|欧美国家|在|疫情|面前|集体|沦陷|而且|还是|在|我们|给|他们|争取|了|1|到|2|个|月|时间|的|前提|下|还有|现成|的|作业|可以|照抄|情况|下|仍然|拿|出来|的|是|如此|难看|的|成绩单|综合|比较|1|月份|以来|海内外|疫情|中|的|表现|可能|找到|答案|欧美国家|拥有|高超|的|医疗|技术|但是|公共|卫生防疫|能力|却|不|一定|高|由于|欧美国家|的|资本主义|社会|属性|欧美|的|很多|医院|尤其|是|一些|著名|的|大|医院|都|是|私人资本|这些|私人|医院|追求|的|当然|的|高超|的|医疗|技术|和|优质|的|服务|但是|他们|的|服务|对象|是|有钱|的|人|古今中外|有钱|的|人|终归是|少数|因此|最|优质|和|最高|超|的|服务|只能|提供|给|有钱|的|富人|而且|在|在|私人|医院|构成|的|大|的|医疗机构|体系|的|之下|欧美国家|诊疗费|很|贵|比如|美国|的|媒体报道|一次|简单|的|急性|感冒|经过|的|简单|的|CT|检查|并|留院|观察|一天|的|费用|就|高达数|万美元|显然|的|这样|的|医疗|服务|只有|缴纳|了|美国|高额|医保|的|人员|能够|享受|普通人|是|无法|享受|的|而|在|提供|公共|医疗|资源|的|医院|则|缺乏|利益驱动|工作效率|低下|以前|加拿大|的|一|一则|新闻|一名|进行|身体检查|的|女性|患者|想要|做|进行|身体|检测|结果|的|她|的|单子|被|拍|到|几个|月|之后|最后|轮到|她|进行|检测|的|时候|发现|她|已经|是|癌症|晚期|而|我国|的|医疗|体系|则|是|由|众多|社区|诊所|乡村|诊所|为|基础|而后|覆盖|乡镇|县区|地|市|各级|各级|公立医院|组成|应对|公共卫生|类|的|这种|公共|疫情|的|医疗|资源|非常|的|丰富|这种|体系|已经|完全|能够|覆盖全国|而且|大多数|是|能够|医保|报销|的|公立|性质|这|在|疫情|只能|发挥|了|重要|的|作用|防疫|政策|执行力|上|西方|更是|远远|落后|抗击|疫情|中|的|一个|重要|举措|是|防控|保障|没有|被|感染|的|人群|不|被|感染|是|防疫|工作|的|重要|组成部分|我们|的|疫情|防护|措施|出台|后|从|基层|的|乡村|社区|都|迅速行动|起来|各种|硬核|而|有效|的|隔离|措施|让|隔离|等|措施|迅速|全面|地|落实|我们|看到|的|防疫|隔离|措施|中|的|老|村长|的|喊声|看到|了|各个|卡点|执勤|的|红袖|标|看到|了|天上|喊话|的|无人机|再|反观|欧美|意大利|的|死亡率|的|世界|第一|但是|喊话|隔离|需要|意大利|的|市长|亲自|上阵|驱赶|可以|毫不客气|的|说|在|隔离|防护|上|意大利|市长|的|工作效率|貌似|赶不上|我们|村|的|村长|而|我们|援助|意大利|的|医疗队|在|实地|查看|的|意大利|疫情|最|严重|的|伦巴第|大区|的|米兰|等|城市|后|得|出来|的|第一条|对|意大利人|的|建议|就是|意大利|根本|就|没有|进行|有效|的|隔离|大街|上|的|人|仍旧|我行我素|互相|拆台|和|八方支援|的|差距|真的|很大|当|2|月份|疫情|爆发|后|我们|看到|了|这样|的|欧盟|意大利|的|口罩|被|德国人|扣留|征用|而|瑞士|的|口罩|消毒|术|先后|被|德国|意大利|扣留|征用|而|塞尔维亚|总统|泪眼|婆娑|的|说|在|欧洲|团结|是|不|存在|只能|在|字面上|见到|当|塞尔维亚|真正|需要|帮助|的|时候|只有|遥远|的|东方|能够|帮助|塞尔维亚|再|看看|美国|美国|的|疫情|在|3|月|王炸|之后|终于|集中|爆发|如今|已经|累计|确诊|病例|超过|21|万|死亡|人数|超过|5100|人|其中|最为|严重|的|是|纽约州|和|加利福尼亚州|都|是|美国|经济|最|发达|的|地区|然而|在|在|美国|可|没有|什么|八方支援|我们|看到|的|是|各州|美国联邦政府|争抢|医疗|资源|就|像|纽约州|长|科莫|所说|各州|争抢|美国|的|医疗|船|最后|纽约州|抢|到|一艘|同时|各州|为了|争抢|紧缺|的|呼吸机|开始|不断|互相|竞价|购买|最后|导致|呼吸机|价格|不断|上扬|再|看看|我们|各省市|的|医疗队|源源不断|的|支援|疫情|严重|地区|这些|最美|的|逆|行者|不惜一切|代价|地|赶往|疫情|一线|参与|战斗|同时|国家|和|各省市|各类|物资|源源不断|地向|疫情|严重|地区|流入|结果|就是|我们|实现|了|控制|疫情|高速|增长|而且|还|保证|了|大量|的|确诊|患者|痊愈|出院|这种|在|紧急|时刻|调动|一切|资源|集中力量|面对|困难|的|能力|是|世界|任何|其他|国家|所|不|具备|的|香港|香港|##|香港|局势|##|网络|名人|同心|战疫|##|美国|禁止|N95|口罩|出口|加拿大|##|电|竞春|晚|##|成年人|常见|潜台词|##|钟南山|呼吁|公众|继续|保持|距离</text>
<comments>再|反观|欧美|意大利|的|死亡率|的|世界|第一|但是|喊话|隔离|需要|意大利|的|市长|亲自|上阵|驱赶|可以|毫不客气|的|说|在|隔离|防护|上|意大利|市长|的|工作效率|貌似|赶不上|我们|村|的|村长
凯总|关于|各国|要|起诉|我国|进行|赔偿|的|事|您|怎么|看|凯雷
这像|一场|战争|并|不是|你|兵|多|粮食|多|武器|好|就|能|赢| | |如何|能|有效|调动|手上|资源|做到|最小|牺牲|赢得|胜利|才|是|根本
严重|同意|这些|天|发达|的|欧美国家|对比|出|我们|国家|是|多么|的|伟大
凯总|的|头像
现在|其实|最|担心|的|不是|欧洲|而是|印度|非洲|啊
文化|不同|加上|国家|处理|方式|不同|但是|对于|传染病|唯一|有效|的|方法|是|阻断|传染源|传染病|不会|管|你|什么|文化|什么|国家
其中|最为|严重|的|是|纽约州|和|加利福尼亚州|都|是|美国|经济|最|发达|的|地区|然而|在|在|美国|可|没有|什么|八方支援|我们|看到|的|是|各州|美国联邦政府|争抢|医疗|资源|就|像|纽约州|长|科莫|所说|各州|争抢|美国|的|医疗|船|最后|纽约州|抢|到|一艘
主要|开始|的|时候|有|一种|狂妄自大|要|什么|自由|啦|又|要|升|么|人权|啦|之所以|导致|现|的|糟糕|吧
我们|能|把|普通|药物|价格调整|到|最低|也|是|原因
别|再说|争取|2|个|月|有|现成|作业|抄|了|意大利|献血|人|很多|不|知道|自己|已经|有|了|抗体|再|加上|最早|跟|中国|断航|却|疫情|极其|严重|有|可能|他们|的|病毒传播|已经|很久|了|那样|说|我们|是|自己|往|身上|揽|责任|吗
著名|的|大|医院|都|是|私人资本|这个|只是|美国|美国|真的|一般|人|看不起|病|法国|还是|公立医院|占多数|意大利|和|西班牙|也|是|看病|没有|经济负担|只是|国外|急症|的|临床经验|不如|中国|可以|说|差太远|的|加上|没有|呼吸机
共同|的|文化|基因|对于|行政命令|的|快速|传达|并|执行|服从|大局|的|传统|道德|的|高压|批判|在|行政|执行力|较弱|地方|的|快速|替补|一方有难|八方支援|的|传统|高|中低端|全面|覆盖|的|医疗|体制|逐渐|增强|的|国力|跟|民族|自信心|真的|是|环环相扣|西方|炒|不了|几千年|的|文化|传统|服从|统一|团结|不屈|没法|抄
朝鲜|做|的|最好|一个|没有
是|的|欧美|虽然|医疗|技术|牛|逼|但是|临床经验|和|反应速度|真的|比不上|国内|的|医生|一天|看|多少|病人|欧美|的|医生|还|能|准时|下班|不|爆发|特大|疫情|他们|刚好|可以|维持|一旦|爆发|医疗系统|一|冲击|就|真的|崩溃|了|以前|还|觉得|他们|挺|平等|经历|这次|事件|是|真的|知道|了|资本家|就是|资本家|我朝|虽然|也|有|资本|但是|该|做|的|还是|会|做
凯总|你|再|不换|头像|凯雷币|要|贬值|了
德国|扣留|瑞士|的|医疗|物资|调查|清楚|之后|早|已经|放行|了|因为|德国|禁止|出口|医疗|物资|国人|都|不|关注|后续|呀
我|爱|我|的|祖国
也|不是|公共|卫生防疫|能力|的|问题|根本就是|体制|有|问题|其一|一方面|为了|保|经济|保|资本|的|利益|一方面|为了|自己|政党|选举|的|利益|领导层|没有|重视|其二|过分|强调|个人|的|自由|本国|的|利益|所以|没有|形成|合力|阻断|病毒传播|为什么|这么|说|因为|后期|祸太大|不得不|牺牲|经济|搞|隔离|等|措施|曲线|就|被|拉平|了
生|为|中国|人|我|骄傲
唉|中国|某些|大|医院|早就|想|医院|私人化|了|欧美|刚刚|爆发|时|某个|医院|的|管理者|就|在|微博|鼓吹|提供|国际|高端|医疗|服务|针对|这个|肺炎|当时|我|怼|了|他|他|还|说|我|不够|自信
依然|是|一个|双刃剑|可|集中|抗疫|也|可|计划生育|若|权力|变坏|一意孤行|之下|又|该|如何|呢|这|是|有|前车之鉴|的
对|在|中国|可以|看见|志愿者|和|个别|人员|为|能够|出去|闯关|而|发生|矛盾|的|案例|在|国外|重灾区|根本|没|看见|也|能|说明|一些|问题
医疗|技术|也|不|一定|高超|我国|就是|长期|被|海外|媒体|精神|pua|了
卫生|诊所|社区|诊所|在|疫情|防控|中有|什么|具体|贡献|吗
上文|一个|观点|不|同意|西欧国家|有|全民|医疗保障|体系|在|正常|情况|下|运转|的|很|好|任何|有病|的|人|都|会|被|诊治|西欧|与|美国|的|情况|完全|不同
经此|一疫|我国|千万|不要|在|实行|减少|公立医院|增加|私立|医院|的|政策|了
0202|年|我们|对待|全国|甚至|全球性|烈性|传染病|的|方法|实际上|和|1918|年|对待|西班牙|流感|时|没有|实质性|区别|医疗|技术|百年|发展|在|防护|和|挽救|个体|生命|上|有|了|长足进步|但|在|控制|疾病|蔓延|的|水平|上|不仅|没|进步|甚至|退步|了|交通|极大|发展|政府|组织|能力|下降
分析|到位
资本主义|医学|研究|是|迎合|市场|为|谋利|的|社会主义|医学|发展|才|首先|是|以人为本|的</comments>