<source>专业版微博平台</source>
<title>#张文宏开讲新冠肺炎防控#（全程） 满满干货！</title>
<time>2020-2-25 11:44</time>
<url>https://weibo.com/2028810631/IvOrdqXCm</url>


<text>新浪|新闻|2020|2|25|11|44|来自|专业版|微博|平台|张文宏|开讲|新冠|肺炎|防控|全程|满满|干货|在|24|日|的|复旦大学|新冠|肺炎|防控|第一课|中|网红|医生|张文宏|讲述|了|人类|社会|对|流感|的|认知|自己|参与|非典|H7N9|禽流感|等|重大|传染病|疫情|的|防控|救治|工作|以及|此次|新冠|肺炎|的|来源|和|特性|防控|方法|和|大学生|返校|注意事项|等|快搬|好|小|板凳|来|听讲|L|视频|||张文宏|复旦|开讲|新冠|肺炎|防控|第一课|4|...</text>
<comments>专业|人事|一定|不能|加网|红|因为|网红|是|名气|医生|是|专业|和|权威|的|象征
医者|就是|医者|不|需要|你|给|他|加个|网红二字|别|拿|那些|垃圾|群体|和|文字|玷污|伟大|的|医者|他们|网红|不配
干嘛|非得|给|人|加个|网红|医生|的|称呼|感觉|怪怪的
他|不是|网红|你|不要|瞎|写
专家|就是|专家|干嘛|➕|个|网红
特别|不|合适|网红|医生|这个|词|请|尊重|专业|和|专业人士|新浪|小编|都|这|文字|是|啥|水平|啊|新浪|新闻
我|现在|就|爱|听|他|说|的|也|就|信|他|说|的
官方|最近|是|咋|了|老想|跟|网红|扯|上点|关系
捧杀
来|了
国人|加油
张爸|说|的|都|中|听
啥事|都|能|和|网红扯|上|关系|网红|可以|没有|文化|和|技术|医者|专家|拥有|的|是|本身|的|才能|他们|可以|影响|到|时代|你|把|网红|从|屏幕|里|拽|一个|出来|看看|真本事|两者|有|可比性|吗
第一网|红|☝|️|不得了|又|看|完|了|还|不|浪费时间|有|营养|又|幽默
看|他|就|知道|腹有|诗书|气自华|来自|专业人士|的|魅力|不可|抵挡|👏|👏
网红|怎么|了|有|啥|难听|的|这样|的|网红|越多越好|网红若|都|是|各|行业|有|责任感|的|专家|是|国|之|大幸
语言|少|了|思想|就|出来|了
外国|的|月亮|圆|外国|的|人头|香
说|了|些|什么|啊
满满|干货|这个|词|看着|很|烦躁|这是|为什么|呀
这|医生|我|喜欢
t
不要|对|医疗界|及|网红界|有|什么|误解|网红|这个|词儿|加|在|别的|行业|人士|身上|可能|增加|点|亲民度|或者|别的|让|人|沾沾自喜|的|东西|医务人员|能|证明|自身|价值|的|只有|过硬|的|专业知识|和|能力|其他|都|是|浮云
硬核|医生|张文宏
加油
书|瞅|千卷
不要|加网|红
记|知识点|记笔记
转发|微博
转发|微博</comments>