<source>专业版微博平台</source>
<title>科技部：可以明确#磷酸氯喹治疗新冠肺炎具有疗效#</title>
<time>2020-2-17 15:38</time>
<url>https://weibo.com/2028810631/IuCypC4L9</url>


<text>新浪|新闻|2020|2|17|15|38|来自|专业版|微博|平台|科技部|可以|明确|磷酸|氯喹|治疗|新冠|肺炎|具有|疗效|科技部|生物|中心|副|主任|孙燕荣|在|会上|表示|疗效|专家组|经过|认真细致|的|研讨|最后|达成|一致意见|一致|认为|磷酸|氯喹|是|一个|上市|多年|的|老药|用于|广泛|人群|治疗|的|安全性|是|可控|的|基于|前期|临床|机构|所|开展|的|临床|研究|结果|可以|明确|磷酸|氯喹|治疗|新冠|肺炎|具有|疗效|基于|当前|临床|救治|的|迫切|需求|专家|一致|推荐|应当|尽快|将|磷酸|氯喹|纳入|到|新|一版|的|诊疗|指南|扩大|临床|适用范围|第一|财经|O|科技部|可以|明确|磷酸|氯喹|治疗|新冠|肺炎|具有|疗效|关注|新浪|新闻|新型|冠状病毒|肺炎|疫情|专题|实时|更新|中|O|聚焦|新型|冠状病毒|肺炎|疫情|聚焦|新型|冠状病毒|肺炎|疫情|抗击|疫情|共克|时艰</text>
<comments>这次|到底|能|不能|信
确定|吗|统一|好|口径|在|发布
希望|可以|统一|一下|由|中央|发出|我们|才|相信
人民日报|双黄连|对|新冠|肺炎|有|明显|抑制作用
只是|告诉|你|有|疗效|不是|预防|别|一窝蜂|又|上去|抢
好消息|希望|能|看到|进一步|的|数据
尽量|多|的|释放|利好|减少|恐慌|必须|要|开工|了|不然|受不了
李|奶奶|这次|不是|我|说|的
怎么|说
观望
本来|这个|就是|治疗|用|的|不是|预防|用|的|所以|等|国家|认可|发布|到|指南|里面|给|医护人员|用|就|好|了|咱们|普通|民众|只|需要|知道|又|有|新|发现|了|有|更|多|的|药物|可以|用|了|不管|新药|老药|发现|有效|就是|利好|啊|给|我们|更加|增添|了|信心|相信|一切|很快|就|能|转好
这次|媒体|的|管控|确实|不好|虽然|都|是|专家|说|的|但是|涉及|到|普遍性|问题|没有|上升|到|国家|层面|统一口径|误导|了|不少|人|不少次
可信|吗
听到|这种|话|就|烦
到底|什么|有效|能|给|个|准话|吗
一切都在|慢慢|变|好
且|听
真是|好消息|呀|能|有|明确|用药|太好了
别|明确|了|过|几天|又|说|不|对|闭嘴|别|讲|了
国家|说|不让|出门|不让|出村|怎么|我们|这边|当官|的|串村|串乡|大拿特|拿|谁|给|老白姓|做主
到底|行不行|啊|心好|累
就|直说|什么|该断|货|了
自己|医院|内部|通告|不|就|好了吗|全|社会|公告|又|等|着|大家|抢|导致|稀缺|吗
又|是|一个|好消息
万能|的|氯奎
又|来|卖|药|了
课|代表|第四个|字|怎么|念
同舟共济|精准|施策</comments>