<source>iPhone 7 Plus</source>
<title></title>
<time>2020-1-22 01:03</time>
<url>https://weibo.com/1496883514/IqzIdAWIs</url>


<text>凯雷|2020|1|22|01|03|来自|iPhone|7|Plus|已|编辑|疫情|当前|楚天|都市报|装作|没事人|好|吗|湖北|楚天|都市报|头版|的|表达方式|让|自己|成为|了|舆论|中心|1|月|18|日|武汉|百步亭|社区|第二十届|万|家宴|举行|4|万多个|家庭|参加|随着|一声|开锅|居民|们|端|出|合作|或|单独|制作|的|13986|道|菜品|...|这是|楚天|都市报|19|日|的|见报|稿件|对|当地|一场|民生|活动|的|表述|O|疫情|当前|楚天|都市报|装作|没事人|好|吗|疫情|当前|楚天|都市报|装作|没事人|好|吗|1|月|18|日|武汉|百步亭|社区|第二十届|万|家宴|举行|4|万多个|家庭|参加|随着|一声|开锅|居民|们|端|出|合作|或|单独|制作|的|1|...</text>
<comments>楼里|有|几个|评论|还|在|给|wh|市政府|洗|地|给|👴|🏻|逗乐|了
感觉|这博主|也|不是|个|好人
所以|年|后|艺考|怎么办|必定|有|武汉|考生|去|外地|考试|艺|考生|的|安全|怎么|保证
虽然|我|也|不|喜欢|传统媒体|一些|做派|但|你|这|言论|我|更|不|喜欢|怎么|管|那么|宽|呢|舆论|战士|和|键盘|侠|有|啥|区别|这个|肺炎|出现|多久|了|大家|心里|都|有数|上面|不|发话|你|能|报|报纸|不|提前|出|菲林|版面|不是|前一天|安排|的|虽然|肺炎|都|是|半夜|给|消息|有|时间|调整|但|人家|就算|应对|不好|怎么|就|被|说|成装|没事人|了
国家级|动员|是|20|号|下午|的|事情|让|地方|半|机关报|承担|独立|调查|媒体|的|职能|你|是|在|装|外宾
我们|也|怀疑|该报|作为|省报|下辖|是不是|跟|武汉市|有仇|¡|评论|配图
被|感染|会|发生|什么|症状|我|昨天|被|一个|咳嗽|了|一下|现在|喉咙|开始|发痒|了
黑龙江|挺住|啊|🙏
不是|开玩笑|的|疫情|有|多|严重|自己|判断|无知|很|可怕|盲目乐观|更|可怕|无知|而|又|盲目乐观|的|结果|是|什么|自求多福|吧
您|觉得|该|怎么样|24|小时|不间断|通知|您|最新|情况|拿|着|喇叭|街上|喊|报纸|非得|是|头条|怕|是|脑子|进|了|水
评论|里|还有|人|说|洗|地|的|这|智商|也|只配|当个|孙子|别人|在|网上|说|啥|他|就是|啥|脑子|长|别人|身上|真可怜
感谢|博主|的|辛苦|整理|和|用心|分享
不|知道|评论|的|某些|人|是不是|wh|市民|呢|如果|是|我|倾佩|您|的|坚强|乐观|如果|不是|我要|骂|您|站|着|说话|不|腰疼|我|同学|在|wh|瑟瑟|发抖|您|还给|报纸|洗底|大过年|的|没|啥|送|的|骂|也|不|合适|送上|祝福|吧|祝您|早日|同|武汉|人民|一起|抗击|肺炎
今年|之所以|继续|举办|这个|活动|是|基于|之前|我们|对|这|一次|疫情|传播|是|对|人|与|人|之间|有限性|传播|的|这个|判断|所以|对|这件|事|预警|不够|那么|后来|确认|人|与|人|的|传播|已经|出现|了|而且|这种|趋势|还有|可能|更加|猛烈|所以|我们|迅速|采取|了|各种|措施|要求|各种|活动|非|必须|不|举办|一天|发|几十条|微博|假装|很|积极|现场|去|吧
武汉|政府|的|做法|自由|国家|去|评判|我们|只能|做好|保护|好|自己|的|准备|少点|人|感染|出门|一定|要|带|口罩|我|在|动|车上|旁边|的|人|一直|在|咳嗽|而且|没带|口罩|早|知道|多带|几个|口罩|了|真想|给|他|一个
人祸|助推|天灾
这报|的|主编|也|是|混得|安逸
大|广东|年|后|希望|能|顶住|这次|灾害
别的|省市|能|不能|也|出台|一些|免费|退票|的|政策|本来|想带|娃|去|芽庄|现在|这么|严重|不想|去|了|机票|不|退|酒店|不退|说|没有|相关|政策|无|语
死亡|宴席
请问|武汉|万|家宴|和|澳大利亚|总理|搞|跨|年|烟火|表演|可以|划等号|吗
为什么|还|聚众|吃饭|啊|有点|不太|重视|疫情
别|挑拨|了
好|恐慌|好|害怕
湖北|电台|今天|一天|都|特|么|是|娱乐节目
早点|休息</comments>