<source>iPhone 7 Plus</source>
<title></title>
<time>2020-1-23 18:41</time>
<url>https://weibo.com/1496883514/IqQ4ljbbQ</url>


<text>凯雷|2020|1|23|18|41|来自|iPhone|7|Plus|武汉|60|岁|退休|公务员|是|怎么|感染|冠状病毒|的|排队|拿药|未戴|口罩|医院|无床|在家|隔离|他|做|过|心脏|支架|每个|月|都|要|去|湖北省人民医院|拿药|最近|一次|拿药|是|在|今年|1|月|12|日|那|时候|大家|都还没|把|肺炎|当回事|官方|公布|的|信息|也|一直|是|可控|可|防|我爸|去|拿药|的|时候|没戴|口罩|排队|排|了|一个|小时|他|推测|很|有|可能|就是|在|那时|感染|的|全国|确诊|新型|肺炎|病例|##|温州|首例|新型|肺炎|确诊|患者|基本|痊愈| |°|武汉|肺炎|重症|患者|一床|难求|三联|生活|周刊||武汉|肺炎|重症|患者|一床|难求|人|如果|在|家里|死|了|是|留|不下|这个|人|的|记录|的|没|人|知道|他|是因为|肺炎|死|的</text>
<comments>从|这个|案例|就|可以|看出|实际|病例|比官|宣|的|多|的|多|的|多|武汉|当局|实在|是|毫无|作为
请|那些|举报|别人|造谣|的|二|傻子|和|抓|人|的|病毒|帮凶|出来|向|这些|人|和|他们|的|家属|忏悔
你|带|节奏|带|的|飞起|做|个人|吧
大|武汉|都|这样|了|春晚|还|能乐|起来|吗
现在|想想|03|年|北京|的|各项|防控|措施|对比|今天|的|武汉|要强|太|多|武汉|现在|的|疫情|程度|感染|人数|已经|让|医疗|资源|承受不住|了|感染者|医院|无力|收治|无法|确诊|只能|带|着|病毒|来回|穿梭|一个个|传染源|得不到|控制|隔离|该谈|什么|防控|呢
就|看|了|你|今天|一天|的|帖子|不是|带|节奏|就是|唯恐|不|乱
这事落|在|哪个|城市|结果|都|一样
社会|需要|这种|真实|的|声音|天天|想|听|好消息|怕|坏消息|引起|恐慌|的|那些|人|和|官员|请问|你们|是|巨婴|吗|需要|人|哄|着|惯着
请|大家|一定|不要|随便|乱|猜测|要|相信|医生|和|专家|不要|随便|造谣|给|他们|造成|困扰|同时|个人|防护|谁|都|不想|生病|但是|当|灾难|来临|的|时候|我们|一定|要|听从指挥|要|冷静|理智|的|看待|问题|现在|最最|重要|的|是|治病救人
目前|是|物资|真的|缺|今天|医院|还有|人|交钱|的|时候|直接|倒下|了|我|怀疑|致命性|变|厉害|了|我们|的|小群|里面|传|了|四个|不同|地方|穿|隔离|服拉人|的|视频|医院|缴费|区人|倒下|的|视频
看|了|太难受|了|让|百姓|相信|什么|啊
这下|好|了|政府|不|恐慌|全世界|恐慌|了
🙏
封|不住|啊|朋友|高铁|上|了|一趟|武汉|广州|南|的|武汉站|不准|上车|人|就|跑|到|咸宁|北上|车|朋友|紧张|的|直立|车门口|不|准备|坐下|了
楼上|那个|凯雷|怎么|就|带|节奏|了
武汉|百姓|可|太苦|了
说明|有|传染|者|这种|情况|很|难过|武汉市|有|这么|多|医疗|人员|能|接待|这么|多|肺炎|感染者|么|周边|的|小|城市|呢|情况|不是|很|好|呢
苍天|啊|医力|不够|不|可以|请求|中央|支援|吗|就让|这么|多|病人|回家|等|死|了
希望|小汤山|尽快|建|好
1|月|17|日|确认|感染|后|没收|治|这是|事实|么
酷|cool|我
找|关系|或许|有床
现在|各大|新闻|置顶|头条|一模一样|都|是|一样|的|我|觉得|这个|时候|应该|把|疫情|置顶
太|可怜
唉
红莉栖|aK
可|防|可控|不是|吗|？
如果|不是|看见|钟南山|出来|说话|我|真的|以为|问题|不|大|之前|粉饰|的|太好了|等|抗过|疫情|该|问责|了
维稳|的|受害者|吗
12|月|31|日|都|说|可控|可|防|不要|相信|谣言|另外|我|是|江夏区|的|我们|上班|到|22|号|之前|从来|没带|口罩|包括|我们|这|附近|所有人|没带|口罩|紧接着|23|号|禁城|一夜之间|满城|口罩|想想|多|恐怖</comments>