<source>iPhone 7 Plus</source>
<title></title>
<time>2020-1-23 03:00</time>
<url>https://weibo.com/1496883514/IqJO6ucef</url>


<text>凯雷|2020|1|23|02|45|来自|iPhone|7|Plus|已|编辑|最|果断|的|决策|封城|第|1|号|指令|全文如下|切断|病毒传播|途径|坚决|遏制|疫情|蔓延|势头|人民|生命安全|第一|市|新型|冠状病毒|感染|的|肺炎|疫情|防控|指挥部|通告|第|1|号|为|全力|做好|新型|冠状病毒|感染|的|肺炎|疫情|防控|工作|有效|切断|病毒传播|途径|坚决|遏制|疫情|蔓延|势头|确保|人民|群众|生命安全|和|身体健康|现将|有关|事项|通告|如下|自|O2020|年|1|月|23|日|10|时起|全市|城市公交|地铁|轮渡|长途|客运|暂停|运营|无|特殊|原因|市民|不要|离开|武汉|机场|火车站|离汉|通道|暂时|关闭|恢复|时间|另行|通告|恳请|广大|市民|旅客|理解|支持|武汉市|新型|冠状病毒|感染|的|肺炎|疫情|防控|指挥部|2020|年|1|月|23|日|新型|肺炎|已致|湖北|17|人|死亡|##|全国|确诊|新型|肺炎|病例|##|武汉|要求|全市|在|公共场合|佩戴|口罩|武汉|封城|#</text>
<comments>早就|该|这么|做|了|弄|的|别的|国家|都|发现|病人|了|还|在|嘴硬
进出|封|了|以后|各地|要|开始|轮流|支援|武汉|支援|湖北|才|对
早该|封城|了|已经|晚|了|很多|人|已经|离开|了
知道|政府|这样|做|是|对|的|也|从|元旦|开始|就|带|着|孩子|在家|不|出门|下楼|倒|垃圾|都|带|了|口罩|很|早就|决定|不|回老家|过年|但是|说心里话|作为|母亲|真的|担心|年幼|的|三个|孩子|作为|独生女|也|真的|担心|在|武汉|周边城市|的|双亲|老家|的|宣传|防范|远远不够|希望|大家|都|能|好好|的|加油
总算|做|了|正确|决定|汉口|火车站|啊|汉口|火车站|早就|该|处理|啊|距离|华南|海鲜|市场|就|900|米
那|高速公路|呢|？
希望|疫情|得到|有效|控制|祈祷|所有|的|医护人员|和|病患者|望|平安|🙏|🙏|🙏|全国|人民|万众一心|众志成城|一定|能够|打赢|这场|病毒|战
如何|定义|封城|怎么|封|何时|封|说|封|就|能|马上|封|么|滞留|在|机场|车站|数以万计|的|人|怎么|处理|经过|武汉|的|飞机|火车|汽车|怎么|处理|车站|滞留|旅客|发生|集体|事件|又|怎么|处理|一个|普通|老百姓|想到|的|问题|国家|一定|想|的|最早|最细|此时|没有|对错|没有|早晚|只有|相信|祖国
只要|你别|把|人|随便|放|出来|武汉|需要|什么|物资|全部|都|支持
大家|出门|都|戴|好|口罩|一定|一定|要|带|保护|自己|的|同时|也|在|保护|别人|武汉|加油
赶紧|修|武汉|的|小汤山|实在|来不及|让|部队|的|野战医院|进场|全国|抽调|医护人员|进|武汉|武汉|的|医疗|资源|本|就|已经|超负荷|微博上|一堆|人|在|求助|太|多|没有|得到|有效|及时|治疗|的|病患|了|封|了|不|代表|就是|放任|武汉|人民|自生自灭
现在|应该|由|中央政府|统一安排|将|部分|病患|转移|至|西安市|等|邻近|省份|重点|城市|医院|救治|同|为|中国|人|于|此|大灾|面前|没有|袖手旁观|的|道理
封城|是|必要|的|但|国家|也|要|支援|超负荷|的|武汉|医院
早想|什么|了
令|我|想起|一部|老电影|卡桑德拉|大桥
今晚|上|武汉|出|城|高速|估计|很快|会|变红|总|有些|自私|的|人会|上演|武汉|大|逃亡
就|像|大连|那个|病患|在|武汉|得不到|医治|冒险|逃出|武汉|疫区|根本|问题|就是|武汉|的|医疗|资源|已经|到|了|极限|所以|不管|怎么样|新|的|医疗|资源|必须|进|武汉|救|人民|救|武汉|了
今日|武汉站|汉口站|武昌站|运输|秩序|正常|共|发送|旅客|29.96|万人|其中|武汉站|发送|旅客|9.31|万人|转自|武汉|铁路
封
一个|星期|前|我|就|说|了|还|被|骂|无论如何|走|在|了|正确|的|路上
可是|高铁|一天|发送|旅客|30|万|依然|严峻|呀
武汉|的|路检|绝对|比|其他|没有|经历|的|人|想|的|严|请|给|武汉|加油|做好|自己|地方|的|防护|而|不是|在|那里|乱码|键盘|分清主次|说|到|个人|换位|思考|你|是|困|在|城里|的|人|你|会|不会|害怕|会|不会|想要|逃跑|我|不|支持|也|要求|人员|不再|流动|但是|过度|谩骂|真的|顶|屁用|不用|显摆|你|那点|流量| |帮助|散播|及时|消息|不好|社会|要|警惕|还是|恐慌
太迟|了
只能|说|加油|武汉|了
1|果断|决策|但是|有些|晚|了|为什么|不|在|学生|放假|以前|春运|开始|前|这么|做|呢|2|不仅仅|是|武汉|凡是|出现|较大|疫情|的|地区|都|要|采取|果断|措施|杜绝|人员|跨区|流动|3|交通部门|人员|密集|地|都|要|采取|严格|的|防控|措施
支持|武汉|正确|决定
迟到|总|比|不到|好|虽然|丧失|了|将|疫情|围剿|在|武汉|城内|的|最佳|良机|但|至少|也|能|在|一定|程度|上|减缓|疫情|的|扩散
以前|有部|电影|卡桑德拉|大桥
这才|是|真正|保护|民众|的|措施
生化危机|的|感觉|有没有|浣熊|市封城|啦</comments>