<source>微博 weibo.com</source>
<title></title>
<time>2020-1-25 21:59</time>
<url>https://weibo.com/1496883514/Ira8NeDzx</url>


<text>凯雷|2020|1|25|21|47|来自|iPhone|7|Plus|已|编辑|这是|战斗|在|武汉|疫区|第一线|社区|的|干部|向|你们|致敬|这是|华南|海鲜|市场|所在|的|街道|—|—|江汉区|唐家|墩|街道|急需|防护|手套|口罩|防护服|消费|物资|请|朋友|们|帮助|文尾|有|街道|滕|主任|的|手机|电话|/|楽|晓家|感谢|🙏|🙏|🙏|🙏|老师|您好|我|是|武汉市|江汉区|唐家|墩|街|的|工作人员|想|找|您|求助|为了|分级|了解|病情|我们|街道|和|社区|的|工作人员|需要|上门服务|街道|这边|也|资源|短缺|了|想|麻烦|您|帮|我们|宣传|下|街道|和|社区|的|工作人员|也|战斗|在|一线|武汉市|江汉区|唐家|墩|街|现在|需要|大量|防护|物资|口罩|手套|防护服|消毒液|等|物资|他们|辖区|有|华南|海鲜|市场|还有|发热|医院|红会|医院|和|隔离|点|街道社区|干部|都|在|一线|进行|各种|保障|宣传|消杀|工作|也|是|奋战|在|一线|需要|保障|保护|的|人|如果|有|物资|捐赠|和|购买|都|可以|如|有|意愿|提供|帮助|可|联系|滕|主任|电话|139|8603|8100|谢谢|啦|全国|确诊|新型|肺炎|病例|##|寻找|染病|列车|乘客|##|全国|确诊|新型|肺炎|病例</text>
<comments>他们|辖区|有|华南|海鲜|市场|还有|发热|医院|红会|医院|和|隔离|点|街道社区|干部|都|在|一线|进行|各种|保障|宣传|消杀|工作|也|是|奋战|在|一线|需要|保障|保护|的|人|如果|有|物资|捐赠|和|购买|都|可以|如|有|意愿|提供|帮助|可|联系|滕|主任|电话|139|8603|8100|谢谢|啦
武汉市|江汉区|唐家|墩|街|现在|需要|大量|防护|物资|口罩|手套|防护服|消毒液|等|物资|他们|辖区|有|华南|海鲜|市场|还有|发热|医院|红会|医院|和|隔离|点|街道社区|干部|都|在|一线|进行|各种|保障|宣传|消杀|工作
一个月|了|都|没|看到|几次|消毒
作为|一个|东北|人|我|奉劝|大家|现在|疫情|贼|拉|严重|老邪候|了|都|老实|消停|的|在家|眯着|得|了|还|扯|啥|啊|南北|二屯|逛|有|啥|好|逛|的|把|炕|烧|热呼|的|掫|瓶|二锅头|钻|被窝|里|蒙大|棉被|就|睡|十五|起来|一|瞅|诶|嘛|雨过天晴|了|操|疫情|过去|了|祝|大家|平安
右边|武汉|居委会|干部|上线|说明|jin123s|感谢|转发|社区|真的|需要|口罩|消毒液|我们|虽然|不是|一线|医务人员| |但是|也|是|每天|排查| | |居民|有|什么|要|解决|的|也|是|第一|时间|找|居委会|/|/|水|之|卑微|感谢|凯|老师|义举|我们|相信|老师|是|核查|过|的|同时|希望|拜托|老师|帮助|的|能|在|您|微博下|自我|说明|让|所有|网友|没|疑虑
凯总|很多|的|转发|都|是|最|实际行动|支持
这是|战斗|在|武汉|疫区|第一线|社区|的|干部|向|你们|致敬|江汉区|唐家|墩|街道|急需|防护|手套|口罩|防护服|消费|物资|请|朋友|们|帮助| |/|楽|晓家|感谢
2020|年|愿望|努力|活下去
感谢您|🙏|🙏|🙏|🙏|🙏
才|在|私信|里|看到|社区|干部|的|需求|信息|而且|是|华南|海鲜|市场|所在|街道|的|我|早|看到|就|好|从|高中生|捐助|到|100|万|只|民用|口罩|中|的|捐赠|部分|捐到|这里|就|好|了|—|最|急需|的|地方|之一|现在|有|捐赠|的|朋友|们|请|帮助|下|武汉|第一线|社区|文末|有|手机
楽|晓家|感谢|🙏|🙏|🙏|🙏|老师|您好|我|是|武汉市|江汉区|唐家|墩|街|的|工作人员|想|找|您|求助|为了|分级|了解|病情|我们|街道|和|社区|的|工作人员|需要|上门服务|街道|这边|也|资源|短缺|了|想|麻烦|您|帮|我们|宣传|下|街道|和|社区|的|工作人员|也|战斗|在|一线
亲爱|的|小米|果果|建议|国家|出面|全国|交通|停止|两周|保障|救援|除外|各种|开工|交期|开学|等|延迟|两周|督促|防范|意识|不强|的|农村|不要|走亲|串邻|让|时间|静止|两周|吧|这个|时候|只有|国家|出面|统一|调控|病情|才能|得到|最大|控制|等到|返工|大潮|到来|病情|恐怕|不好|控制|与|生命|比|起来|还有|什么|更|重要|的|呢
转发|微博
一线|的|战士|只有|各省市|的|白衣天使|唐家|墩|作为|华南|海鲜|市场|政府|管理|部门|你们|真的|把|市场|管|好了吗|我|所在|的|小区|也|在|唐家|墩|有|任何|宣传|吗|小区|垃圾|满地|都|是|物业|不管|不问|求别查|水表|我|一|普通|老百姓|惹不起

唐家|墩|街道办|真|以为|你们|辖区|的|老百姓|不上|微博|吗|你们|该|作为|的|时候|干嘛|去|了|不要|以为|老百姓|都|是|傻子
武汉|班子|还是|都|这时候|还|没有|专门|部门|统一|收集|捐助|物资|统一|发放|这样|可以|提高|物资|的|使用|效率|这样|各个|医院|自行|求助|有|的|接收|的|多|有|的|接收|的|少|有些|混乱|长|点心|吧|武汉|的|班子
要|啥|啥|没有|领导|还开|团拜会
我们|这种|应急|机制|是不是|世界|首创|啊|凯总
凯叔|口罩|让|国家|层面|解决|吧|浙江|嘉兴|街道|卫生院|基层医院|的|口罩|也|不够|用|了
领导|们|要|社区|人员|到|辖区|居民|家|摸排|情况|登记|为什么|不|给|人家|配置|防护用品
华南|海鲜|确实|属于|唐家|墩|街道|可是|这么|多年|很多|市民|反映|该|市场|脏乱差|的|问题|各|部门|包括|街道|完全|不|作为|不|管理|才|爆发|现在|的|恶劣|后果
妈|的|湖北省|长|不是|说|什么|都|充足|了|吗
华南|海鲜|市场|罪恶|之源|胡吃海塞|这是|大自然|对|人类|无知|无畏|的|报复|与|惩罚
这样|呼吁|能|解决|根本|问题|吗|当|全国|都|找|你|的|时候|咋办|要|从|根本|下手|呀
不够|？|湖北省|长|不是|说|物资|充足|吗
看看|上海|政府|在|干什么|武汉|封城|前夜|高铁|抵沪|武汉|人|不|测温|放行|目前|全国|各省|防御|不断|升级|情况|下|搞|这出|应该|是|仅次于|湖北|政府|的|迷惑|行为|大赏|吧|¡|评论|配图
评|什么|论

这|段时间|我|一直|以为|我们|社区|的|人|都|走光|了|呢|懒|的|说|对|塘|蔡|社区|你们|有|多|失望|幸亏|我们|香四有|很多|有|经验|的|医护|系统|退下来|的|老干部|们|纯粹|靠|自救|要|你们|有|何用</comments>