<source>iPhone 7 Plus</source>
<title></title>
<time>2020-1-27 20:24</time>
<url>https://weibo.com/1496883514/Irss0bruJ</url>


<text>凯雷|2020|1|27|20|24|来自|iPhone|7|Plus|非常|棒|的|建议|我|沒|有|想到|不吃|野味|与|新|门神|钟南山|当|写入|教科书|与|高考|中|考试卷|相信|教育部门|今年夏天|以后|一定|会|考虑|我|有|个|想法|以后|不能|吃|野味|必须|写|进|小学|课文|就|以|这次|肺炎|为例|英雄人物|就是|钟南山|院士|因为|小学|教育|深入人心|像|火山|邱少云|一样|全人类|都|会|认为|这是|英雄| | | | | | | | |只出|律法|没|办法|完全|禁止|思想|扭曲|的|人|去|吃|野味|只能|从|娃娃|抓起| | | | | | | | | |我|一个|人|没|渠道|给|建议|凯雷|认为|对|的话|再|发个|微博|征求|下博友|的|意见|人多|力量|大</text>
<comments>很|好|的|建议
在|这个|时候|也|请|媒体|关注|一下|在|社区|里养|鸽子|的|情况|在|社区|里|养活|禽对|居民|潜在|的|威胁|始终|存在|而且|其|对|哮喘病|人|的|正常|生活|影响|也|很大|为什么|这么|多年|没有|人|解决|这个|问题|呢
好|建议|文明|社会|不乱|吃|野味|保持|生态系统|文明
教育|学生|不吃|野味|比|立法|更|有效
这个|建议|好
确实|是|好|的|提议|支持
建议|是|好|的|但|效果|是|不能|保证|的|这些|人有|几个|不|知道|不|应该|吃|野味|法律|有|教育|指引|预测|评价|强制|作用|加上|从小|的|道德|教化|的确|可以|在|一定|程度|上|增加|宣传|效果

从|教育|开始|好|办法
赞同
嗯|先|说明|杠精别|老|说|我|挑刺儿|只是|看到|实在|是|觉得|有点|别扭|文字|中说|的|应该|是|火|烧|邱少云|吧
试卷|都|会|出|一些|积极|正|能量|的|东西
健忘|是|我们|的|传统|疫情|结束|用|不了|太久|野味|就|又|会|回到|人们|的|餐桌|立贴|为证
我|觉得|好|建议|而且|必须|采纳|这是|人类|的|生活|教训|必须|告诉|我们|的|下一代|让|他们|避免|再次|经历|这样|的|病毒
架不住|那种|家长|的|言传身教|啊
转发|支持
完全|赞同|出发点|不仅仅|为了|防止|疾病|更|多|的|是|保护|动物|和|珍惜|自然环境|我们|人类|必须|从|孩子|抓起|才|有|未来
这个|办法|的确|好|将|2003|年|非典|和|这次|新|冠状病毒|一起|这写|进|中小学|课本|同时|建议|中小学|开设|急救|课程|包括|地震|火灾|如何|逃生|日常|救助|比如|噎住|了|人工呼吸|胸部|按压|这些|我|从小到大|都|没学过|所以|知识|都|是|空白|的
好
你们|怎么|不|怪|病毒
慈悲|的|教育|如果|普及|会|更好|不吃|还会|打|打|了|就|会|吃
鸽子|是不是|野味
很|好|的|建议|一百个|赞同
关乎|人类|生存|有|必要
分析|得|很|对|所以|建议|也|是|很|硬核|啦
应该|发给|一些|人大代表
支持|支持
奋战|在|一线|的|医务|工作者|冒|着|感染|风险|顶|着|上级|封口|的|压力|在|防护用品|不足|的|情况|下|仍然|尽心尽力|处置|疫情|救护|病员|应该|以|群体|之名|留名|青史
是|的|不过|难|政府|的|思维|琢磨不透|毕竟|很多|政府|官员|吃|野味
敬畏|自然|的|教育|应该|从|娃娃|抓起|这次|再|加上|非典|学费|好贵|还学|不会|就|真的|。|是</comments>