<source>微博 weibo.com</source>
<title></title>
<time>2020-1-21 22:24</time>
<url>https://weibo.com/1915371620/Iqxj2pY7Q</url>


<text>赫|莲娜|2020|1|21|18|55|来自|iPhone|客户端|作为|这次|新型|肺炎|重灾区|的|武汉|人|我们|家|2|位|家人|正|面临|着|生死考验|先生|已|于|元月|2|日|开始|高热|不|退|用药|无效|肺部|感染|收入|武汉|传染病|医院|救治|中|家父|一直|同|住|于|元月|8|日|开始|高热|肺部|感染|武汉|协和|发热|门诊|治疗|无效|10|日|我们|要求|住院治疗|被告|之无床|回家|等|侍|后续|转|至|武汉|新华|医院|检查|告之|打针|观察|3|天|无|改善|病情|更|严重|告之无床|每天|拖|着|沉重|的|70|岁|身体|去|医院|打针|吸氧|直至|昨晚|上|已经|12|天|了|还是|发热|中|已经|出现|呼吸困难|却|无|医院|可以|收治|也|无|病毒|排查|无|隔离|任其发展|生命|危急|和|可能|的|扩散|无时|不|在|恳请|有关|部门|关注|和|给予|妥善解决|长江|云|官方|微博|央视|财经|21|世纪|经济|报道|新华网|头条新闻|人民日报|武汉市|政府|武汉市|卫生|健康|委员会|中国青年报|湖北|之声|楚天|都市报|楚天|交通广播|作家|陈岚</text>
<comments>患病|的|老人|已经|严重|呼吸|障碍|刚才|打|120|要求|送|去|之前|治疗|的|武汉协和医院|救护车|工作人员|坚决|不送|说|是|只能|就近|武汉|十一|医院|到|了|十一|医院|拒收|我们|要求|再|送|协和|或|去|每天|打针|的|新华|医院|被|救护车|工作人员|以|发热|症状|医院|肯定|不|收|他们|送|的|好多|病人|都|被|拒|了|必须|自己|和|医院|联系|好|才|送|因此|拒绝
感谢|广大|网友|的|关注|家父|昨天|经过|周折|总算|收入|汉口|医院|武汉|卫健委|领导|看到|微博后|马上|联系|我|已经|协助|安排|并告|之|院方|承诺|不会|再|被|推|积极|救治|愿|每|一位|患者|都|能|得到|系统|检查和|救治|最终|康复|无论是|新型|病毒|肺炎|或|其他|病毒|肺炎|都|有|传播|性|无论如何|大家|都|需要|做好|防护|愿|平安|健康|天佑|武汉
8|号|的|CT|给|所有|关心|的|网友|O|网页|链接
13|号|血|氧|饱和度|O|网页|链接
现在|医院|超负荷|在|运转|最好|可以|把|病例|关键|信息|打码|发出|大家|才|好|100%|转发|你家|先生|已经|被|收治|老人|更不应|被|拒绝|因为|我|外婆|曾住|一|医院|对面|病房|爷爷|年纪|很大|前几日|一|发烧|就|马上|转院|隔离|非常|及时|还有|去|小区|里|抓|病人|的|不会|放任|传染源|在外|请|不要|再|加深|医患|矛盾|了|我们|需要|医生|和|护士
愿|平安|啊|在|新华网|看到|你|的|信息|了|我|相信|很快|会|重视|起来|的|🙏|🙏|🙏|🙏
这么|严重|都|不管|的|么
医院|不收|也|不怕|蔓延|么|唉|祝好
除了|这次|的|肺炎|请博主|考虑|是否|血管炎|成人|still|类|的|免疫病
感觉|这是|一个|骗子
评论|不要|乱带|节奏|博主|如果|你|说|的|是|真的|我|建议|你|直|可以|接|去|疾病|控制|预防|中心|求助
看|了|下面|的|评论|真的|是|心|凉了半截|我|本人|不|学医|只能|尽|一点|微薄|之力|转发|祈求|平安
帮转|/|口|口|小馒头|我|妈妈|和|你|父亲|情况|一样|我|妈妈|已经|持续|发烧|确诊|肺炎|十多天|了|一直|在|人民|医院|发热|门诊|打针|医生|说会|传染|要|自行|隔离|但|我|妈妈|要求|做|新型|病毒|检查|却|被|医生|拒绝|我|妈妈|心|都|凉|了|一直|在|发烧|家里|还有|两个|80|岁|老人|我|怀孕|了|也|一直|没|和|妈妈|见面|每天|我|爸爸|送|医院|她|一个|人|打针
祝安
13|号|的|CT|O|网页|链接
祝福
目的|是|解决问题|也|不是|针对|谁|一定|会|没事|的
祝愿|你|父亲|和|丈夫|早日康复
是|一直|不能|确诊|么
现在|怎么样|了|持续|关注|祝好
也|不|知道|现在|怎样|啦|你|自己|也|要|保重|啊
请|上传|病历|先|特殊|时期|医疗|资源|注意力|资源|都|有限|必须|合理|分配
祝福|您|一家人|都|能|平平安安
武汉协和医院|及|同济|医院|的|病人|已|远远|超过|负荷|请|大家|就近|发热|门诊|就诊|避免|乘坐|地铁|或|公交|另外|医护|已经|极度|疲劳|超负荷|运转|请|不要|因为|排队|焦虑|对|他们|恶言相向|另外|不|收治|情况|也|请|尽快|核实|处理
我|妈妈|和|你|父亲|情况|一样|我|妈妈|已经|持续|发烧|确诊|肺炎|十多天|了|一直|在|人民|医院|发热|门诊|打针|医生|说会|传染|要|自行|隔离|但|我|妈妈|要求|做|新型|病毒|检查|却|被|医生|拒绝|我|妈妈|心|都|凉|了|一直|在|发烧|家里|还有|两个|80|岁|老人|我|怀孕|了|也|一直|没|和|妈妈|见面|每天|我|爸爸|送|医院|她|一个|人|打针|吃饭|跑|了|很多|家|医院|都|不收
所以|说|武汉|应急|管理|就是|一坨|屎|本来|不至于|这么|严重|的
她|文章|里|根本|没说|确诊|新型|肺炎|啊|微博有|好几个|都|是|普通|肺炎|说|自己|新型|肺炎|故意|怪罪|医院|怎么|可能|真的|有病|医院|怎么|可能|不收|的|啊|没道理|啊|医患|关系紧张|真|就是|这样|搞|出来|的|🙉
私|以为|博主|话语|过于|片面|现在|这种|时期|肯定|是|排除|了|武汉|肺炎|协和|等|医院|长期|无床|特别|是|呼吸|这种|内科|预约|时间|可能|长至|一个|到|几个|月|无床|的|情况|下|门诊|打针|交叉感染|的|几率|很大|特别|是|这次|主要|易感|人群|就是|中老年|言辞|中|弱化|自己|强化|医护人员|不管不顾|不|知道|是|想|煽动|群众|还是|怎么|有人|喷|我|当|我|没|说
请|核查|这例|病人|是否|为|新型|冠状病毒|感染|武汉|发布|健康|武汉|健康|武汉|官微|/|赫|莲娜|病人|姓名|徐恩恩|男|69|岁|武汉|协和|新华|医院|武汉|普仁|医院|发热|门诊|都|已登记|在案|我们|有|病历
武汉市|市长|应|辞职|如此|无德无能|还有|脸当|市长</comments>