<source>iPhone 7 Plus</source>
<title></title>
<time>2020-1-24 10:34</time>
<url>https://weibo.com/1496883514/IqWj728U9</url>


<text>凯雷|2020|1|24|10|34|来自|iPhone|7|Plus|已|编辑|领导|没有|先走|真的|战斗|在|抗疫|第一线|之前|武汉|卫健委|副|主任|传言|逃跑|几乎|让|人|信以为真|查证|是|假|本人|始终|战斗|在|一线|今天|刚|看到|湖北省|商务厅|副厅长|黄谋宏竟|也|感染|新|冠状病毒|之前|感冒|严重|体力不支|站|都|站不住|从|武汉|回来|请|自行|隔离|##|高校|必要|时|可|调整|教学|安排|##|新型|肺炎|不|构成|国际|突发|卫生事件|##|全国|确诊|新型|肺炎|病例|##|武汉|女|医护人员|自发|剪掉|长发|##|疫情|地图|##|小汤山|非典|医疗队|请战|书|##|武汉|一名|新型|肺炎|患者|被|成功|救治</text>
<comments>黄|厅长|怎么|这么|快|就|入院|并|确诊|了
商务厅|跟|防疫|没有|直接|关系|大|概率|是|个人|原因|导致|得病|和|数千|武汉|群众|没有|不同|不要|什么|都|往|疫情|上|靠
副厅长|是不是|看|戏|时候|感染|得|呀
团拜会|参加|了|吗|会|不会|那个|生病|演员|传|出来|的
也|有|可能|是|开|胜利|大会|传染|的|呢
感冒|生病|了|需要|休息|网络|上|出现|假消息|辟谣|发布|准确|的|信息|是|重要|选项
向|虽然|素味|平生|但|却|在|这次|病毒|危机|中|始终|不眠不休|奔走|急呼|的|凯|总|致以|崇高|敬意
也许|是|晚会|上|被|传|的
多|看看|晚会|就|好|了
病毒|无情|人|有情|每当|国家|有难|总会|有|一些|蝇营狗苟|的|妖魔鬼怪|出来|但是|我国|更不缺|舍身救人|的|勇士|愿|前线|医务人员|和|病毒感染|患者|平平安安|🙏|🙏|🙏
为什么|每次|遇到|事情|都|会|有|那么|多人|去|制造|谣言
辛苦|了
就是|团拜会|有个|演员|好像|也|是|患者|但|还是|去|参加|演出|了
那么|多|排队|的|人|都|没|确诊|呢|黄|厅长|怎么|走|的|绿色通道
楼主|弱弱|问|一句|南水北调|渠会|有|影响|么
团拜会|还是|应急|厅|的|春晚|感染|的
评论|区|翻车|了
不|传谣|不|听谣|不信谣
祸害|别人|也|祸害|到|自己|了
我|的|印象|笔记
死而后已|还|差点|火候
但|省委书记|省长|还开|团拜会
本来|老实|呆|在|家里|基本|没事|偏要|往|车站|重灾区|跑|我|担心|年|后|的|情况|全部|奔|向|大城市
湖北|荆州|伤|医案|新|发
为啥|不|早点|行动|呢|已经|有|了|非典|等|交心|和|经验|早点|通知|人人|戴|口罩|多好|一月|就|建|隔离|医院|这时|早就|可以|住进|病人|了
智商|呢|晚会|的|时候|都|确诊|了|还|看个|p
排队|没
不是|因为|参加|当地|春晚|吗
黄|厅长|一看|生个|病死|不了|还|能|入院|隔离|乌纱帽|可能|也|丢|不了|了|赶紧|采取|了|此|措施
你|往后|稍|一|稍|先|闭上嘴|吧</comments>