<source>iPhone 7 Plus</source>
<title>#传染病学专家表示疫情已刻不容缓#</title>
<time>2020-1-25 22:58</time>
<url>https://weibo.com/1496883514/IraBAyTxs</url>


<text>凯雷|2020|1|25|22|58|来自|iPhone|7|Plus|已|编辑|这个|问答|专业|实际上|实质|上|科学|回答|了|一个|全国|人民|关心|的|问题|疫情|管控|解除|有没有|一个|时间表|李兰娟|院士|新|发病|人|明显|减少|甚至|没有|了|管控|就|可|解除|注意|1|新|发病|人|2|至少|明显|减少|凝哲|同学|波子哥|廖新波|传染病|学|专家|表示|疫情|已|刻不容缓|传染病|学|专家|李兰娟|接受|央视|访时|表示|武汉|实施|进出|人员|管控|是因为|疫情|已到|刻不容缓|的|程度|只有|严格控制|传染源|才能|不让|传染病|发生|大|流行|现在|全国|多省|都|有|输入|性病|人|必须|采取|严格|措施|否则|疫情|可能|继续|蔓延|她|表示|新|发病|人|明显|减少|甚至|没有|了|管控|就|可|解除|L|央视|新闻|的|微博|视频</text>
<comments>这个|问答|专业|实际上|实质|上|科学|回答|了|一个|全国|人民|关心|的|问题|疫情|管控|解除|有没有|一个|时间表|李兰娟|院士|新|发病|人|明显|减少|甚至|没有|了|管控|就|可|解除|注意|1|新|发病|人|2|至少|明显|减少
我|觉得|大家|做好|保护措施|就行|非典|那次|毕竟|网络|没有|现在|发达|不要|过度|恐惧|加油
这次|比|非典|还|难|难|就|难|在|时间|紧迫|2|月份|要|复工|开学|3|月份|要开|两会|而|03|年|是|在|两会|以后|才|全面|爆发|没有|时间|上|的|压力
钟|组长|好|几天|没|露面|了|谣言|四起|传谣|被|感染|也|不|视频|漏面|辟谣|担心|啊
她|说|的|很|明白|为啥|有人|听不懂
李|院士|吧|....
通过|政府|的|措施|跟|一些|病例|的|感染|细节|判断|武汉|的|情况|已经|很|严重|了|武汉|加油
损失惨重
应该|说|没有|时间表|有|解除|管控|标准
那|春节假期|是否|要|延后
死亡|人数|继续|攀升|你|说|明显|减少|了
这个|记者|的|表情|真让人|厌恶
尊重|科学|不要|过于|悲观|也|不要|过于|乐观|沉着|迎战|积极|应对|痛定思痛|认真总结|依法|惩处|警示|后来|/|找|一个|理由|说|我|很|好|转发|微博
为什么|不是|甲类|传染病|呢|哪位|大神|解释一下

这位|阿姨|反应|真|快|特别|聪明
转发|微博
我|觉得|第二代|甚至|是|第三代|传染|的|病人|肯定|已经|大批|出现|了|只不过|还|来不及|统计|和|检查
给出|了|一个|标准|发现|华夏|/|/|老妖|观察|转发|微博

回家|洗洗|睡|吧
这|可比|有些|只|知道|让|民众|放松|警惕|的|专家|强多|了
这是|什么|节目
怀念|柴静
酷|cool|我
浙江人|的|骄傲|杭州|浙江大学|第一|医院|中国工程院|士|一同|和|钟南山|抗击|SARS|也|70|多岁|了
這次|肺炎|病毒|本身|致命|率不高|但是|它|的|傳播|速度|快|傳播性|广才|是|最|致命|多次|交叉|傳染變|异會|導致|病毒|升級|增加|未知|不|可控|的|因素|太|大|所以|国家|才|如此|重視|看看|最近|的|中央|政策|基本|都|是|関閉|公共|場所|封閉|交通|然后|告誡|大家|不要|群体|活動|就是|最大|程度|避免|因為|人員|流動|造成|多次|交叉感染|帶來|的|變异|風險
我|最|想要|知道|的|是|这|药物|和|医疗|啥时候|能|解决|这种|病
既然|封城|建议|早已|提出|考虑|方方面面|观察|了|几天|那|为啥|观察|的|这|几天|不|开始|封城|的|准备
宜宾|挺住|武汉|加油</comments>