<source>微博 weibo.com</source>
<title>#意大利出现1例疑似新型肺炎病例#、英国发现新型肺炎疑似病例</title>
<time>2020-1-24 17:18</time>
<url>https://weibo.com/1618051664/IqYWXapHu</url>


<text>头条新闻|2020|1|24|17|18|来自|微博|weibo|com|已|编辑|意大利|出现|1|例|疑似|新型|肺炎|病例|英国|发现|新型|肺炎|疑似病例|据|意大利|共和国|报|23|日|报道|意大利|南部|城市|巴里|出现|一例|新型|冠状病毒|感染|肺炎|疑似病例|另据|独立报|英国|近日|发现|14|例|疑似病例|其中|5|人|检验|成|阴性|另|9|名|患者|正在|等待|检验|结果|意大利|媒体|透露|该国|的|疑似病例|是|一名|歌手|曾到|中国|武汉|演出|出现|发烧|咳嗽|等|感冒|症状|目前|该|患者|正在|接受|隔离|治疗|其|采检|样本|已|被|送往|罗马|等待|结果|英国|出现|新型|冠状病毒|感染|肺炎|疑似病例|后|英格兰|公共|卫生局|表示|暂时|不能|透露|患者|在|何处|接受|治疗|唐宁街|发言人|强调|对|疑似病例|进行|检测|是|纯粹|的|预防性|措施|目前|没有|确诊|病例|关注|新浪|新闻|疫情|地图|实时|更新|中|O|网页|链接|新|京报</text>
<comments>上联|书记|省长|喜迎|团拜会|下联|医生|护士|赴死|抗|肺炎|横批|众志成城|上联|不顾一切|逃离|重灾区|下联|顾全大局|遭难|无人管| |横批|孰是孰非
丢人|丢|到|国外|了
那|看|了|那场|演出|的|观众|也|很|危险|啊
请求|上升|国际|公共卫生|紧急事件
我|现在|就|想|知道|初七|到底|怎么|回去|上班
今天|是|除夕夜|目前|最想|看到|的|一条|新闻|新型|冠状病毒|成功|得到|控制|再|无|人员|感染|所有|医护人员|平安|拜托|了|大家|出门|戴|口罩|勤洗手|多喝水|多|吃水果|提高|免疫力|保护|好|自己|的|身体|照顾|好|自己|和|家人
你|是|病人|又|tm|不是|丧尸|你|到底|瞎|跑|什么|瞎|跑|￥
Sars|猪瘟|新型|冠状病毒|我们|中国|人|的|形象|在|世界|伟岸|而|勇敢|什么|都|敢|吃
能|不能|说明|是|哪|一场|啊
天佑|中华|一定|会|好|的
到|武汉|就|能|被|传染|这是|什么|机率
首先|要|保护|好|各位|医护|工作者|保证|医生|的|人员|安全|防护|工作|和|宣传|力度|一定|要|加强|还有|街上|为何|还|那么|多人|不|戴|口罩|并且|很多|长辈|依然|觉得|不|需要|戴|口罩
妈耶
这群|逃跑|的|憨|批
真他妈|全球|开花|吃|野味|的|真|能耐
根据|安莎社|最新|的|报道|出现|在|意大利|巴里|的|疑似病例|初步|检验|呈|阴性
武汉|🐔|熟|了|外国|也|也|要|骂|死|我们|了
用|5g
武汉|要|传染|全球|啦
特么|的|全球|发射|病毒
好惨
武汉|到底|感染|了|多少|人
看来|这次|新型|冠状病毒|来势|相当|凶险
哎
还|看到|有|从|南昌|出发|的|武汉|人|跟|团游到|意大利
不是|已经|辟谣|了|么
意大利|也|中招
我滴|妈|耶</comments>