<source>微博 weibo.com</source>
<title>上海海关全速通关进口基因扩增试剂 可辅助检测新冠病毒</title>
<time>2020-1-27 11:43</time>
<url>https://weibo.com/1618051664/Irp2saZbp</url>


<text>头条新闻|2020|1|27|11|43|来自|微博|weibo|com|上海海关|全速|通关|进口|基因|扩增|试剂|可|辅助|检测|新冠|病毒|1|月|26|日|上海|吴淞|海关|全速|通关|一批|自|立陶宛|进口|的|基因|扩增|试剂|澎湃|新闻|记者|从|上海海关|获悉|该批|试剂|用于|辅助|检测|新型|冠状病毒|具备|高效|高灵敏度|的|特点|共计|1235|盒|经营|单位|为英|潍捷基|上海|贸易|有限公司|与此同时|吴淞|海关|第一|时间|通过|进口|防控|物资|快速|通关|受理|专窗|对|上述|物资|实施|快速|验放|全力|保障|防控|新型|冠状病毒|感染|的|肺炎|防控|物资|迅速|通关|澎湃|新闻</text>
<comments>中华|思源|工程|扶贫|基金会|捐款|使用|存疑|中华|思源|工程|扶贫|基金会|于|2020|年|1|月|5|日|在|微博微|公益|平台|发起|慈善|捐款|截止|目前|已|募集|千万|善款|在|微博上|公示|的|口罩|采购|价格|高且|不|符合|医院|需求|标准|供货商|是|中间商|且|有|过|罚款|记录|公示|的|采购|合同|无|双方|签字|盖章|不|符合规范|请求|政府|关注|人民日报|央视|新闻
大家|关注|环卫工人|天天|接触|特别|是|废弃|的|口罩|等等|的|垃圾|希望|都|能|给|他们|提供|必备|的|口罩|等|基本|物资|还有|很多|空巢|老人|和|一些|流浪汉|希望|都|能|得到|相关|地区|的|照顾
上海
科学家|给力
已经|有人|开始|回收|口罩|了|大家|口罩|一定|剪掉|再|扔|不要|让|本|应该|保护|我们|健康|的|口罩|成为|新|的|病毒传播|物|我|接力|一次性|口罩|不|一定|是|最好|的|选择
上海海关|效率高
这个|太好了
加油
好消息|啊
Takara|果然|没牌面|Invitrogen|果然|就是|质量|好
这个|玻璃|好羡慕|我|在|法院|立案|大厅|工作|好|担心|上班
海关|也|给|力|👍
保证|速度|的|同时|安全性|也|要|保证|防人之心|不可|无
现在|口罩|真的|是|一罩|难求|请问|N95|口罩|和|医用|一次性|还|生产|吗|现在|药店|网上|口罩|都|被|卖光|了|怎么办|央视|新闻
中国|加油
好
我|想|知道|第一个|得病|的|叫|啥|名
家人|奋战|在|一线|她们|医院|也|买不到|口罩|帽子|防护服|了|有|资源|的|麻烦|联系|我|多谢
上海|吴淞|海关|👍|👍|👍|👍|👍
为|公司|点赞|👍
真的|要|科学|封路|啊|村里|现在|救护车|进不来|出不去|耽误|了|很多|病情|有|的|人|要|买菜|买|药都|没|办法|出去|商铺|关门|超市|现在|出去|买不到|菜|和|吃|的|大家|都|在|混|抢|这样|下去|大家|的|生活|怎么|保障|我们|感冒|发生|都|在|家里|没|办法|出去|买药|科学|封路|啊|现在|农村|搞|得|太过|了
海关|效率高|架不住|地方|政府|懒政|推脱
17|年前|那场|非典|所有|感染|死亡|的|全部都是|东|亚裔|今年|武汉|新型|肺炎|病毒|传染|速度|与|烈度|数倍|于|SARS|病毒|然而|迄今为止|所有|感染|与|死亡|的|患者|仍然|全都|是|华裔|自然界|进化|出来|的|病毒|何时|做到|如此|之|精准|定位|感染|对象|科学|允许|质疑|喷|我者|请|自吞|粪污|要么|给出|你|知道|的|科学|解释|要么|闭嘴
环卫工人|应该|免费发|N95|口罩|他们|舍不得|买|也|买不起|每年|三百六十|多天|就|大年初一|休|一天|现在|中国|人离|了|他们|更|不行
请|给|环卫|一线|人员|免费|足量|发|N95|口罩|他们|不|舍得|买|也|买不起|城市|离|了|他们|还|不行|每年|他们|就|大年初一|休息|一天|其他|三百六十|多个|凌晨|都|上班|现在|对|中国|人|他们|更|重要
加油
英|潍捷基|代理|的|是|赛默|飞世尔|的|试剂|又会有|毫无|智商|的|阴谋论|来|了
立陶宛|准备|得|比较|超前</comments>