<source>iPhone 7 Plus</source>
<title></title>
<time>2020-3-19 19:30</time>
<url>https://weibo.com/2549228714/Izlqsmy1O</url>


<text>英国|那些|事儿|2020|3|19|17|13|来自|微博|weibo|com|已|编辑|一个|让|人|有点|不知|如何|评价|的|新闻|两人|偷情|导致|整个|城镇|被|封锁|一名|已婚|的|阿根廷|女子|从|西班牙|回来|之后|感觉|身体|不适|但|她|碰巧|遇见|了|自己|年少时|的|恋人|男方|在|知道|女方|有|疑似|新冠|症状|的|情况|下|依然|坚持|为|爱|鼓掌|完|事后|男子|回|了|自己|的|家乡|Selva|直接|去|参加|了|个|有|20|人|的|庆祝|趴体|他|在|趴体|上|喝|得|酩酊大醉|跟|大家|讲述|自己|破镜重圆|的|浪漫爱情|故事|还|提到|女方|好像|得|了|新冠|结果|所有人|都|被|吓|得|半死|立刻|上报|当局|然后|男子|所在|的|有|2500|人|的|小镇|被|全部|封锁|了|现在|这名|女子|身份|被|确认|已经|被|隔离|她|的|丈夫|也|被|隔离|了|…|…</text>
<comments>倾城|之恋
她|丈夫|这个|绿帽|大到|全世界|都|知道|了
求|丈夫|的|心理|阴影|面积
老公|从|新闻|上|得知|自己|被|绿|了|一边|平静|的|接受|隔离|一边|流下|了|感动|的|泪水
让|我|想起|那个|去|韩国|找小三|结果|小三得|了|新冠|但是|妻子|没事|的|新闻|了
男方|在|知道|女方|疑似|新冠|病症|的|情况|下|依旧|为|爱|鼓掌|还|去|参加|趴体|…
想起|了湾湾|那个|台商
这|一集|中国|也|演过|了|比如|出轨|男|跨城|武汉|会小三喜|得|肺炎|病发|隐瞒|行程|奸情|终|败露|接下来|的|剧本|应该|还会|有|痴情女|抢|得|口罩|送|情郎|薄情|男|转送|口罩|予小三|疫情|时期|的|爱情|剧本|丰富|着|呢
特鲁多|妻子|确诊|特鲁多|没事|她|的|健身|教练|确诊|了
我|记得|传染病|里|南湖|老婆|就是|0|号|病人|偷偷|去|了|情人|所在|的|城市|后来|男主|老婆|和|男主|老婆|的|情人|都|死|了
我|并|不想|欣赏|这个|类型|的|瘟疫|时期|的|爱情|更|别提|还|尼玛|是|偷情
死|了|都|要|爱|？
西班牙|有家|妓院|也|被|封|了|不|知道|被|隔离|的|人|怎么|和|老婆|交代|不能|回家|的|理由|呢
迷惑|行为|大赏
好像|传染病|的|情节
哎|我|老公|隔壁|桌|一个|人|疑似病例|现在|他们|整个|曼城|办公室|都|关|了|大家|都|在家|隔离|十四天|我|老公|要是|被|传染|了|我|也|歇菜|了|我|都|不敢|告诉|我|爸妈
求|她|老公|此时|的|心理|阴影|与|肺部|阴影|面积
疫情|下|的|爱情|¡|评论|配图
有部|电影|叫做|传染病|不|知道|大家|看过|没有
坚持|为|爱|鼓掌|太|感动|了
现在|全世界|都|知道|了
感觉|像是|会|出现|在|某|黄黑|网站|的|剧情|走向|...
新|题材|的|爱情|电影
生命诚可贵|爱情价更高
霍乱|时期|的|爱情|...
隔离|完|了|这婚|也好|离|了|吧
这事|给|其他人|造成|的|心理|阴影|面积|多大|不|知道|肺部|阴影|面积|可以|确定|是|很大|了
所以|没事儿|别说|电视剧|狗血|....
电影|传染病|的|剧情
真是|胆大|不怕</comments>