<source>微博 weibo.com</source>
<title></title>
<time>2020-3-4 15:10</time>
<url>https://weibo.com/1496883514/Ix3cVaM5K</url>


<text>凯雷|2020|3|4|15|10|来自|微博|weibo|com|已|编辑|新华社|山东省|任城|监狱|疫情|事件|已|查清|经|专业|调查|任城|监狱|疫情|事件|是|由|1|月|21|日|从|武汉|自驾车|到达|山东|济宁|的|人员|传染给|监狱|干警|职工|进而|造成|部分|干警|和|罪犯|感染|山东省|对|11|人|立案|调查|对|陈民华|任城|监狱|职工|戴|光辉|涉嫌|妨害|传染病|防治|罪|立案侦查|山东|通报|任城|监狱|新冠|肺炎|疫情|调查|处理|情况|从|山东省|纪委|监委|省委|政法委|获悉|经|前期|对|任城|监狱|发生|新冠|肺炎|疫情|问题|调查|山东省|纪检监察|机关|已|对|省|司法厅|原|党委书记|厅长|省|监狱|管理局|原|党委书记|第一|政委|解维俊|省|监狱|管理局|原|党委|副|书记|政委|姜运华|省|监狱|管理局|原|党委委员|副局长|王文杰|任城|监狱|原|党委书记|监狱长|刘葆善|任城|监狱|原|党委|副|书记|政委|刘勇刚|任城|监狱|原|党委委员|副|监狱长|陈为宁|任城|监狱|原|党委委员|副|监狱长|邓体|贺|任城|监狱|原|党委委员|副|监狱长|房德峰|任城|监狱|四级|高级|警长|王文东|任城|监狱|干警|陈民华|孟祥磊|等|11|人|涉嫌|严重|违纪|违法|问题|立案|审查|调查|检察机关|对|王文杰|刘葆善|邓体|贺|等|3|名|司法|工作人员|涉嫌|玩忽职守|罪|等|罪名|立案侦查|公安机关|对|陈民华|任城|监狱|职工|戴|光辉|涉嫌|妨害|传染病|防治|罪|立案侦查|记者|4|日|从|中央|政法委|获悉|日前|经|中央|批准|由|中央|政法委|副|秘书长|雷东生|任组长|中央|政法委|最高人民检察院|公安部|司法部|有关|负责同志|参加|的|调查组|就|山东省|任城|监狱|疫情|事件|进行|了|全面|调查|主要|情况|已|查清|调查组|认为|任城|监狱|原|领导班子|官僚主义|形式主义|严重|对|监狱|防控|工作|特殊性|复杂性|敏感性|认识|不足|思想|麻痹|管理|松懈|致使|干警|职工|带病|入监|疫情|迅速|扩散|山东省|司法厅|监狱|管理局|作为|上级|主管部门|对|任城|监狱|疫情|防控|工作|督促|指导|不力|失察|失职|针对|任城|监狱|原|有关|负责人|及|相关|干警|职工|在|此次|疫情|事件|中|涉嫌|玩忽职守|滥用职权|妨害|传染病|防治|等|行为|调查组|建议|相关|纪检监察|机关|和|司法机关|依纪|依法处理|针对|山东省|司法厅|监狱|管理局|原|有关|负责人|督促|指导|不力|失察|失职|等|问题|调查组|建议|相关|纪检监察|机关|和|司法机关|依纪|依法处理|山东省|司法厅|原|厅长|等|11|人|被|立案|审查|调查组|认为|任城|监狱|疫情|事件|的|发生|反映|出|监狱|管理|同|国家|治理|体系|和|治理|能力|现代化|要求|还有|不小|差距|监狱|管理|部门|应当|吸取|深刻|教训|举一反三|树立|新|时代|监狱|安全|理念|把|教育|改造|宗旨|体现|到|刑罚|执行|工作|中|进一步|健全|监狱|监督管理|体制|机制|切实加强|干警|队伍|建设|不断|提升|监狱|管理|现代化|水平|新华|视点|记者|刘奕湛</text>
<comments>山东|任城|监狱|疫情|事件调查|公布|武汉|自|驾回|山东|者|传染给|狱警|进而|造成|部分|干警|和|罪犯|感染
李文亮|的|快|一个月|吧|没|消息|了|遗忘|了
看|明白|了|就是说|之前|处理|的|那些|官员|不|冤枉|而且|还有|人|漏掉|了|这次|要|把|漏网之鱼|全部|追加|处罚
幸亏|监狱|直属|省|管理|济宁|吓|出|一身|汗
是|原来|济宁|那里|谣传|的|那个|事儿
监狱|管理局|是|一个|存在|时间|很长|相对|独立|的|二级|局|平常|很少|出门|脸|也|不刷|存在|感|估计|都|没想|起来|这个|实盘|存在
人员|是|谁|为啥|每次|结果|都|是|这么|有|心机|领导|就|说|领导|干警|就|说|干警|干警|家属|就|说|干警|家属|领导|养|的|小|三|就|说|扯|这么|多|干嘛
当时|全国|几个|省|的|监狱|同一天|公布|数据|了|吧
1|月|21|日|从|武汉|自驾车|到达|山东|济宁|的|人员|这些|都|是|什么|人员|为何|如此|神秘| |想象|空间|太大|了
图片|评论|¡|评论|配图
这个|中央|成立|了|调查|后|省里|就|没有|成立|调查组|这个|调查组|调查|的|结果|真实性|比较|大
转发|不让|人|看|了
真的|监狱|被|感染|是|我|始料未及|的|不过|也|是|情理之中|监狱|是|一个|巨大|的|培养皿|没有|感染者|出现|就是|避风港|一旦|病毒|进入|就|如鱼得水|开始|畅游
任城|监狱|疫情|事件|是|由|1|月|21|日|从|武汉|自驾车|到达|山东|济宁|的|人员|传染给|监狱|干警|职工|进而|造成|部分|干警|和|罪犯|感染|—|句子成分|好|复杂
任城|监狱|一下子|让|山东|到|了|倒数|第二|依法|从严|从重从快|严惩不贷
新冠|导火索|引爆|好多|热点
谁|自驾|从|武汉|到任|城|又|传染给|谁|是|怎样|传染|的|没|说
湖北|立案|调查|了|山东|一看|不|公平
冗长|的|文字|也|没|说|明白|到底|是|咋|回事
為|所欲|為
监狱|劳改|等|地方|管理|的|问题|是不是|可以|彻底|揭一|揭盖子
抓|了|就|毙|了|学学|北韩
被|感染者|免费|治疗|吗
开车|的|人|是|谁|是|干嘛|的
</comments>