<source>iPhone 7 Plus</source>
<title></title>
<time>2020-3-23 12:06</time>
<url>https://weibo.com/1261093102/IzQ1Y8xyl</url>


<text>三观|美丽|梁兴扬|2020|3|22|23|08|已|编辑|拒绝|隔离|大闹|重庆|机场|撕毁|防疫|登记|旅客|信息|表|的|自述|自己|是|上海|市民|从|泰国|普吉岛|回来|落地|上海|后|转机|重庆|11|号|就|回到|上海|上海|给|她|发|了|绿码|但|防疫|人员|询问|她|拿不出|任何|证明文件|说明|是|哪里|人|与|素质|无关|逻辑|链是|该|女子|自述|是|上海|市民|用来|证明|自己|从|泰国|落地|上海|获得|上海|绿码|其余|只能|等待|后续|报道|请极|个别人|不要|口口声声|说|地域|歧视|自己|却|对|其他|地方|的|人|地域|歧视|甚至|低于|攻击|央视|评|回国|女子|大闹|机场|L|全真道士|梁兴扬|的|微博|视频</text>
<comments>我|真|不|明白|一群|所谓|上海|人|一边|骂|外地人|东北|逼|外地|逼|一边|骂|我|地域|歧视|我|只不过|是|如实|陈述|女子|的|自述|口音|不|代表|不是|上海|人|户籍|证明|才|是|哪怕|你|一口|伦敦|腔|也|不|代表|你|就是|伦敦|人|口口声声|喊|着|地域|歧视|自己|却|拼命|地域|歧视|个别人|不要|自我|优越感|爆棚
没|素质|的|女人|与|地域|无关
东北|疫情|期间|全力|支援|可能|因为|她|在|某些|地域|黑|那里|功亏一篑|了|不要|因为|一个|人|定义|东北|人|或者|上海|人|哪里|没有|坏人|呢|而且|我|觉得|那些|地域|黑|就是|你|所在|地域|的|渣|渣|干嘛|急|着|暴露|自己
有人|说|这个|女人|没说|她|上海|人|我|造谣|3|分|36|秒|该|女子|女子|亲口说|我们|上海市|人民|我们|小区
/|肉|很多|的|喵|小姐|东北|疫情|期间|全力|支援|可能|因为|她|在|某些|地域|黑|那里|功亏一篑|了|不要|因为|一个|人|定义|东北|人|或者|上海|人|哪里|没有|坏人|呢|而且|我|觉得|那些|地域|黑|就是|你|所在|地域|的|渣|渣|干嘛|急|着|暴露|自己
央视|评|回国|女子|大闹|机场
直接|拷|走|完事
你|是|上海|人|就|可以|横着|走|吗
视频|里|她|自己|说|是|东北|人|新|上海|人|怎么|不说|自己|是|外星人|的|啦|上海|让|她|落户|也|是|倒霉
我|代表|我|自己|重庆|人|表示|太丑|了|我们|其实|不想|接收
不要|来|祸害|重庆|了
从|国外|回来|自称|上海|人|的|东北|人|在|重庆|大闹|没|意识|到|自己|得罪|了|多少|城市|吗|😑
这|就是|上海|不|作为|造成|的|从|泰国|回来|不|应该|隔离|14|天|吗|至少|居家|隔离|14|天|吧|从|上海|跑|到|重庆
一口|一个|瑞典人|的|你们|又|高潮|了|东北|没|好人|就|有|泼妇|是|吧|地域|黑才|消停|几天|没完|了|是|吧
每回|东北|人|踏踏实实|做点事|取得|点|成绩|之后|就|会|窜出|一颗|光洁|优质|的|老鼠屎|均匀|涂抹|在|东北|人|的|风评|上|身为|一个|东北|人|真是|心累
她|自家|强调|了|一下|是|新|上海|人
作为|一个|东北|人|看|了|评论|真的|非常|伤心|之前|骂|特朗普|种族歧视|的|时候|一个|比|一个|高潮|现在|搞|地域|歧视|倒|是|义正|言辞|援|鄂|的|时候|就是|一省|包一市|我们|都|是|一家人|这会儿|又|一口|一个|瑞典人|你们|跟|国外|那些|不分青红皂白|就辱华|的|憨|批有|什么|区别
东|baby|冒充|上海|人|自己|却|说漏嘴|不过|有|一句|话|我|很|纳闷|她|说|我|东北|人|你们|一个|都|骂|不过|我|所以|在|东北|骂人|厉害|是|很|光荣|的|事|吗|是|可以|拿|出来|炫耀|的|事|非常|不|理解|瑞典人|把|素质|差|当做|自己|的|特殊|能力|来|炫耀
这年头|还|地域|黑|不|都|是|中国|人|好笑
一般|东拉西扯|的|都|是|没有|真|东西|的
新|上海|人|东北|的|不知|落户|了|没有|原来|闵行|有|个|在|公示|期间|抢|公交|方向盘|被|判刑|取消|落户
11|号|入境|在|哪儿|都|得|集中|或|居家|隔离|14|天|吧|至少|要|到|25|号|她|怎么|从|上海|飞|出来|到|重庆|的|呢|登记|没有|提示
拷|走|了|事|中国|实在|是|太|民主|了|呼吁|美国|的|专制|警察|作风
死肥婆
所有|的|东北|人|都|应该|看看|这|条|下面|的|评论|网络|暴力|地域|歧视|从来|没有|远离|我们|我们|却|要|倾囊相助|去|维护|民族大义|这|和|中国|在|国际|上|的|际遇|何其相似|中国|默默|的|承受|着|而|东北|人|却|要|承受|着|国内|国外|的|种种
上海|发布|隔离|没|满|十四天|为什么|会|有|绿卡|？
事情|先不说|看|她|满嘴|脏话|蛮横无理|的|样子|就|想|打爆|她|的|头
谁|告诉|你|重庆|人|骂|不|赢|你|的|人家|不说|普通话|分|分钟|搞定|你
请|参考|上海|那个|洋女婿
我|是|上海|人|新|上海|人|我|东北|人|你们|一个|都|骂|不过|我|敢于|承认|是|瑞典人|还是|好|的|别|到时候|屎盆子|往|上海|身上|扣</comments>