<source>iPhone 7 Plus</source>
<title></title>
<time>2020-3-23 10:20</time>
<url>https://weibo.com/1496883514/IzON4mgCs</url>


<text>凯雷|2020|3|22|19|59|来自|iPhone|7|Plus|已|编辑|社区|网格|员|心声|现在|疫情|得到|了|控制|反而|一纸|通告|说|我们|不是|疫情|防控|人员|这样|定性|我们|很|伤心|服务|群众|初|心|我们|没有|懈怠|国家|下拨|下来|的|防疫|补贴|直接|就|给|我们|砍|了|一半|只|给|100|剩下|的|进|了|谁|的|口袋|凯总|您好|我来|给|您|说|说|具体情况|我们|辛辛苦苦|两月|疫情|平稳|了|反而|蚌埠|民政局|说|我们|不是|疫情|防控|人员|说|我们|不|适用|国家|发布|的|疫情|补贴|那|我们|从|年初一|到|现在|一直|在|忙活|什么|确诊|病例|封楼区|我们|社区|工作人员|上|送|密接|人员|去|隔离|点|我们|社区|工作人员|上|给|封楼|居民|送菜|到家|保障|生活|一天|几十|上百|趟|也|是|我们|上|现在|疫情|得到|了|控制|反而|一纸|通告|说|我们|不是|疫情|防控|人员|那|请问|疫情|严重|的|时候|真正|的|疫情|防控|人员|在|哪里|现在|疫情|控制|住|了|复工|复产|了|然后|想|卸磨杀驴|了|我们|真|不是|图钱|谁家|也|不缺|那|几千几百|的|主要|是|市政府|这样|把|我们|社区|工作人员|定性|我们|很|伤心|我们|天天|干|防疫|工作|的|活|到头来|我们|却|连个|名分|都|没有|而且|国家|下拨|下来|的|防疫|补贴|直接|就|给|我们|砍|了|一半|只|给|100|剩下|的|进|了|谁|的|口袋|我们|不要|钱|我们|都|愿意|把|钱|捐给|支援|一线|的|医务人员|但是|这样|扣|我们|的|钱|而且|还|否定|我们|的|工作|性质|我们|真的|坐不住|了|网格|员|真的|很|可怜|什么|保障|都|没有|在|基层|我们|是|最忙|的|群体|但是|我们|为了|服务|群众|的|初心|我们|没有|懈怠|防疫|初到|现在|我们|算|蚌埠市|社区|工作人员|没有|一个|人|退缩|我们|也|有|家庭|儿女|老人|当|我们|穿|上|防护服|甚至|不|穿|防护服|就|上|确诊|病例|楼道|的|时候|我们|觉得|这是|责任|这是|义务|我|没有|一个|人|害怕|但是|现在|蚌埠市|政府|把|我们|的|名分|取消|把|我们|的|奖励|剥削|把|我们|的|心|放在|地上|踩|碎|我们|欲哭无泪|现在|网络|上|开始|大肆|的|删帖|大肆|的|威胁|大肆|的|雇佣|水军|来|黑化|我们|抹杀|我们|如果|我们|的|权益|这样|被|抹杀|真不知道|我们|以后|的|工作|该|如何|开展|感谢您|为|我们|发声|全|蚌埠市|基层|社区|防疫|工作人员|都|感谢您</text>
<comments>确诊|病例|封楼区|我们|社区|工作人员|上|送|密接|人员|去|隔离|点|我们|社区|工作人员|上|给|封楼|居民|送菜|到家|保障|生活|一天|几十|上百|趟|也|是|我们|上
现在|疫情|得到|了|控制|反而|一纸|通告|说|我们|不是|疫情|防控|人员
3|月|20|日|中午|外面|下起|了|鹅毛大雪|我|看到|我们|小区|门口|的|协管员|坐在|那里|瘦弱|的|身躯|上|全是|雪花|她|冻|的|瑟瑟|发抖|没有|一口|热水|我|问|她|你们|这么|辛苦|有没有|补助|她|回答|就|一个月|1000|多|块钱|工资|当时|我|转过身|眼泪|流|了|下来
这么|基层|还|算不上|一线|疯|了|吧|下沉|的|基层|劳务|派遣|临时工|不|被|民政部|承认|为|社区|工作者|一线|防疫|人员|没有|补贴|已经|够|惨|了|没想到|辛苦|的|社工|们|被|统计|信息|了|还是|没有|相应|的|补贴|果然|全部|没有|编制|的|临时工|都|半斤八两|的|惨|啊|寒心|呐
当初|疫情|最|严重|的|时候|社区|人员|挨家挨户|上门|排查|各个|小区|都|要|按|人头|管理|他们|是|真正|的|一线|这样|对待|基层|党员|让|人|寒心
网格|员|真的|很|可怜|什么|保障|都|没有|在|基层|我们|是|最忙|的|群体|但是|我们|为了|服务|群众|的|初心|我们|没有|懈怠
这么|让|人|寒心|的|事情|可比|美国|疫情|重要|多|了|愣|是|没人|关注|也|没什么|曝光|没有|基层人员|的|辛苦|能|有|今天|的|好|局面|那些|民粹|死|哪|去|了
也|不|意外|了|我|知道|的|很多|地方|除了|警察|和|医生|其他人|是|提|都|没|提到|说|有|补贴|的
那|请问|疫情|严重|的|时候|真正|的|疫情|防控|人员|在|哪里|现在|疫情|控制|住|了|复工|复产|了|然后|想|卸磨杀驴|了
别哭|你|是|东北|男人|/|南無法帝|的|微笑|3|月|20|日|中午|外面|下起|了|鹅毛大雪|我|看到|我们|小区|门口|的|协管员|坐在|那里|瘦弱|的|身躯|上|全是|雪花|她|冻|的|瑟瑟|发抖|没有|一口|热水|我|问|她|你们|这么|辛苦|有没有|补助|她|回答|就|一个月|1000|多|块钱|工资|当时|我|转过身|眼泪|流|了|下来
这|很|符合中国|基层|现状
我们|天天|干|防疫|工作|的|活|到头来|我们|却|连个|名分|都|没有|而且|国家|下拨|下来|的|防疫|补贴|直接|就|给|我们|砍|了|一半|只|给|100|剩下|的|进|了|谁|的|口袋
社区|工作者|在|过年|期间|和|疫情|最|严重|时期|24|小时|守护|在|小区|门口|他们|的|辛苦|有|良心|的|人|都|能|看在眼里|他们|的|努力|是|应当|得到|大家|认可|的|但|最近|看到|了|有些|人|不知|是|出于|什么|目的|一方面|否认|了|他们|的|付出|一方面|又|恶意|诋毁|他们|希望|大家|能够|正视|这个|问题|不要|做|令人心寒|的|事|恶语伤人|六月|寒
这个|需要|国家|明确|指引
如果|我们|的|权益|这样|被|抹杀|真不知道|我们|以后|的|工作|该|如何|开展| |感谢您|为|我们|发声|全|蚌埠市|基层|社区|防疫|工作人员|都|感谢您
被|人|揩油|了
您好|我来|给|您|说|说|具体情况|我们|辛辛苦苦|两个|月|现在|疫情|平稳|了|反而|蚌埠市|民政局|说|我们|不是|疫情|防控|人员|说|我们|不|适用|国家|发布|的|疫情|补贴|那|我们|从|年初一|到|现在|一直|在|忙活|什么
是|不过|三|非典|也|发生|过|这样|的|事情|现在|又|发生|等到|万一|第三次|那|就|只能|要|那|帮人冲|上|一线|了
用|脚指头|想想也是|前线|的|都|是|基层|啊|包括|社区|包括|民警|什么|的|领导|偶尔|出来|打|酱油|吧
疫情|期间|社区|的|所有|工作人员|是|最|危险|最累|最忙|的|一群|人
防疫|初到|现在|我们|算|蚌埠市|社区|工作人员|没有|一个|人|退缩|我们|也|有|家庭|儿女|老人|当|我们|穿|上|防护服|甚至|不|穿|防护服|就|上|确诊|病例|楼道|的|时候|我们|觉得|这是|责任|这是|义务|我|没有|一个|人|害怕
就|最近|的|形势|只能|说刀亮|早|了
谢谢
曝光|出来
我们|真|不是|图钱|谁家|也|不缺|那|几千几百|的|主要|是|市政府|这样|把|我们|社区|工作人员|定性|我们|很|伤心
既然|不是|那|就|干脆|没|补贴
奇葩|的|管理
你们|多多少少|还有|100|我|也|是|网格|员|我们|一分钱|也|没有
安徽|根本|没有|疫情|你们|穷|忙活|个|啥|呢|幸亏|政府|明查|秋毫|要|不|国家补贴|就|被|你们|骗走|喽
寒|了|人心</comments>