<source>专业版微博平台</source>
<title>基因组“实锤”！#韩某为此轮哈尔滨疫情传播源#</title>
<time>2020-4-28 21:28</time>
<url>https://weibo.com/2028810631/IFsbP9SdH</url>


<text>新浪|新闻|2020|4|28|21|28|来自|专业版|微博|平台|基因组|实锤|韩某|为此|轮|哈尔滨|疫情|传播|源|4|月|28|日|记者|从|黑龙江省政府|新闻|发布会|获悉|经|中国|疾控中心|哈尔滨|医科大学|等|有关|专家|调查|分析|现有|研究|结果|更|支持|从|美国|归来|的|留学生|韩某|为此|轮|哈尔滨|疫情|反弹|的|传播|源|4|月|15|日|黑龙江省|疾控中心|将|有关|两个|批次|采样|送|至|中国|疾控中心|进行|全|基因组|测序|我们|送|的|两批|样本|拿到|了|21|人|的|全|基因组|序列|数据|中国|疾控中心|哈尔滨|医科大学|生物|信息|专家|对|基因组|序列|数据分析|发现|这些|基因组|序列|间|99.99%|是|一致|的|其中|有|18|个人|的|基因组|是|完全相同|的|另外|三人仅|相差|1|2|个|核苷酸|中国工程院|院士|哈尔滨|医科大学|校长|黑龙江省|医学|科学院|院长|张|学说|对|21|人|的|基因组|分析|确定|为|1|个|传播|链|也|就|证明|病毒|是|通过|一个|人|传开|的|通过|基因|测序|分析|明显|看到|这个|传播|链|的|新冠|病毒|基因组|序列|与|中国|人群|中|以往|测过|的|病毒|基因组|序列|是|明显|不|一样|的|张|学说|测序|结果|支持|传播|源|来自|国外|是|境外|输入|病例|综合|考虑|基因组|测序|分析|流行病学|调查|证据|关联|等|信息|目前|更|支持|韩某|是|此次|疫情|反弹|的|传播|源|对|韩|某|在|哈尔滨|结束|居家|隔离|后|曾|与|家人|共同|进餐|还|曾|前往|上海|进行|手术|但|目前|却|未|造成|其他|相关|人员|感染|的|情况|张学|解释|道|韩某|解除|在|哈尔滨|的|居家|隔离|时|有关|部门|对|其|几次|进行|核酸|检测|都|呈|阴性|但|两次|IgG|抗体|检测|是|阳性|证明|其|已有|了|特异性|抗体|通俗|讲|韩某|体内|的|新冠|病毒|已经|被|自身|免疫系统|打败|传染|他人|的|机会|已经|大幅度|下降|了|张|学说|这|在|某种程度|上|意味着|此时|韩某|通过|近距离|接触|将|病毒|传染给|他人|的|可能性|已经|降低|了|央视</text>
<comments>感觉|这个|疑点|还是|蛮|多|的|为啥|她|家人|没|感染
个人|推测|韩某|在|居家|隔离|期间|其实|就是|新冠|肺炎|感染者|至于|几次|核酸|检测|都|没|检测|出来|这样|的|例子|非常|罕见|但是|不是|没有|韩某|最后|解除|隔离|时|已经|不|具有|传染性|了|只能|说|新冠|病毒|太|狡猾|了|我们|对|这种|新病毒|了解|的|还是|太少|了
隔离|期满|出来|活动|也|没什么|来源|是|她|但是|这|不能|怨|她
公布|这个|还是|没|说服力
根本|就|解释|不通|家里人|什么|事儿|没有|邻居|却|病|了
那|请问|韩某|结束|居家|隔离|后|已|产生|抗体|传染|他人|概率|大幅|降低|那|她|的|第一|传播|人|邻居|曹某|是|怎么|被|传染|的|是|在|韩|某|隔离|期|被|传染|楼上楼下|共同|污染区|下水道|还是|韩某|结束|隔离|后|传染给|曹某|的
那|她|去|上海|那|一路
划|重点|美国|归来
传播|途径|不明|传染|逻辑|不通|那么|多|归国|人员|之前|报|的|境外|输入|也|不少|啊|有没有|那些|人|发生|本地|传播|的|可能|结果|这样|就|实锤|确定|感染|源|真的|石锤|啊|...|追查|传染源|并|不是|说|要|追究|谁|的|责任|而是|有助于|加深|对|病毒|的|认知|对|现有|的|措施|查缺|补漏|这样|掩耳盗铃|.....|欲加之罪|何患无辞
只是|说|病毒|是|国外|来|的|为什么|就|一定|是|韩|某|也|有|可能|说|接触|过|别人|被|传染|的|呢
病毒|可|千万别|变异|不然|全世界|都|得|遭殃
居家|隔离|时|她|家人|没传上|把|同栋楼|的|给|传上|了
xxxx|xxxx
这|之前|被|网友|勾画|的|狗血|剧|终于|破案|了
这个|病例|我|没|怎么|看|懂|...|好像|记得|是|3|号|解除|居家|隔离|5|号|去|上海|做|美容|手术|那么|是|怎么|感染|邻居|的|家人|和|上海|目前|都|没有|病例|呀
韩|她|爸|传染给|楼下|的|曹|曹|传染|了|整个|哈尔滨
毒王
所以|有没有|人|为此|负责|呢
去|美国|留学|危险|都|别去了
也|是|可怜
可|参考|对|哈尔滨|传染源|的|详解
你|让|隔离|她|隔离|了|你|把|她|放|出来|现在|出事|怪|她|呵呵
广大群众|一定|要|保护|好|自己
集中|隔离|可能|就|没|这么|多|事儿|了
通过|基因|测序|分析|明显|看到|这个|传播|链|的|新冠|病毒|基因组|序列|与|中国|人群|中|以往|测过|的|病毒|基因组|序列|是|明显|不|一样|的|张|学说|测序|结果|支持|传播|源|来自|国外|是|境外|输入|病例|是|这|不是|说|美国|流行|的|新冠|与|我们|的|不同|美国|他们|胡说八道|如果|稍|有点|科学|考证|想|说|他们|的|新冠|是|由于|中国|都|站不住脚|呀
在|韩国|这样|的|人|要|判刑|的
这|就|锤|啦|还是|有|很多|逻辑|节点|没有|疏通|啊
这一炮|真贵
从|国外|输入|的|病例|尤其|是|欧美国家|的|一定|要|进行|基因|测序|对|查找|病毒|来源|和|研究|病毒|变异|很|重要</comments>