<source>微博 weibo.com</source>
<title>治愈患者出现“复阳”，#病毒是否非常顽固和狡猾#？</title>
<time>2020-3-5 23:23</time>
<url>https://weibo.com/1618051664/IxfRCc6bT</url>


<text>头条新闻|2020|3|5|23|23|来自|微博|weibo|com|治愈|患者|出现|复阳|病毒|是否|非常|顽固|和|狡猾|军队|前方|专家组|组长|刘又宁|病毒|太|狡猾|了|是|可能|的|不过|还有|三个|层面|要|考虑|1|试剂盒|的|质量|很|不|统一|检测|技术|也|不|统一|有时候|采集|样本|也|会|出现|误差|所以|我|觉得|应该|统一标准|统一|方法|在|不同|的|地区|做|一个|比较|大|的|规模|的|调查|才能|确实|证明|是|都|真的|出院|以后|阳性|及|阳性|比例|有|多少|2|可以|排除|是|二次|感染|因为|出院|的|病人|都|在|进行|隔离|接触|不到|传染源|并且|体内|已经|有|抗体|了|所以|不会|发病|的|3|有些|病毒感染|后|上呼吸道|甚至于|以后|一个月|内|能够|分离|出|病毒|或者|核酸|检测|也|不少|见|但|病毒|的|状态|数量|是否|有|传染性|这些|问题|是|关键|新闻|一加|一|L|新闻|一加|一|的|微博|视频</text>
<comments>把|所有|的|所谓|痊愈|者|都|筛查|几遍|是|必须|的|这|应该|是|马上|进行|的|不能|有|片刻|的|拖延
这|病毒|感觉|是|目前为止|最|狡猾|的|了
说|了|三个|层面|唯独|没说|是不是|太|追求|治愈率|很多|复阳|的|病人|其实|根本|就|没有|完全|治愈
我|又|来|了|我|这里|检查|咽|试纸|肛拭|子|大便|小便|痰|液|眼泪|全部|连续|4|次|阴性|才能|出院|然后|再|到|医院|隔离|14|天|继续|检查|4|次咽|拭子|和|肛|拭子|全部|阴性|才能|算|治愈|我|就是|这么|过来|的
都|会|好|起来|的|中国|🇨|🇳|必胜
在|彻底|全部|治愈|之前|我们|都|要|严防死守
你|不|重视|病毒|病毒|就|会|重视|你
撸|起|袖子|加油|干
病毒|太|狡猾|了
是不是|评判|治愈|的|标准|还|不够|成熟
春天|马上|来|了|感谢|我|生活|在|这么|强大|的|国家|骄傲
别|解释|了|你|越|解释|我越|糊涂
不要|为了|复工|而|放宽|出院|标准|政府|宣布|复工|我们|为了|恰饭|也|会|乖乖|上班|啊|放|这么|多复阳|的|反而|不能|上班|了
试剂盒|质量|不|统一|就是|有|质量|差|的|咯|取样|问题|人为|原因
尤其|是|核酸|试剂盒|每个|厂家|都|有点|不|一样
还是|要|注意|防范
第一条|很|敢讲|实话
还是|不|能够|松懈|啊
加油|加油|加油|加油
会|好|起来|的|中国|加油
加油
几个|月|了|还|不|统一
说|得|理性|而|实在|加强|筛查|和|防控
所以|即使|治愈|了|也|还要|做好|防范|工作|啊
治愈|患者|出现|复阳|病毒|是否|非常|顽固|和|狡猾|虽然|有|各种|可能性|要|加以|注意|但|这次|的|病毒|无疑|很|成功|的|给|人类|来|了|带来|了|一波强|冲击
有点|担忧|哦|😟
转发|微博
太|可怕|了|这个|病毒
太难|对付|了
与其|问|病毒|为什么|复阳|不如|问|身体|为什么|会复弱|呢|陷入|纳米|纳米|的|那个|圆形|冠状|物体|反而|对长|约|一两米|重达|一|两百斤|的|巨大|物体|视而不见|了</comments>