<source>微博 weibo.com</source>
<title>欢迎你们回家，#国门为同胞而开而非为病毒# </title>
<time>2020-3-18 14:40</time>
<url>https://weibo.com/7150896479/Iz9SUEi0Z</url>


<text>京彩|好评|2020|3|18|11|50|来自|iPhone|客户端|已|编辑|欢迎|你们|回家|国门|为|同胞|而开|而|非为|病毒|随着|全球|疫情|加剧|新增|境外|输入|病例|数|已经|超过|了|本土|新增|病例|的|数字|为此|北京市|宣布|了|防控|新举措|境外|人员|来京|一律|先送|隔离|点|隔离|14|天|费用|自理|北京|战疫|全力以赴|祖国|今日|之|成绩|来之不易|但|只要|你|持有|中国|护照|祖国|任何|时候|都|向|你|敞开|怀抱|也|请|京彩|好|网民|朋友|们|一定|要|如实|报告|自身|的|健康状况|隐瞒|才|会|造成|更大|的|麻烦|同样|各地|隔离|的|居住|条件|是|有|差别|的|万事|没有|尽善尽美|遇到|不合|心意|的|就|当|人生|中|的|一段|修行|毕竟|比起|生死|这些|都|不算什么|我|心中|的|廉洁|L|京彩|好评|的|微博|视频</text>
<comments>还要|加|一条|非|中国籍|境外|人员|包括|外籍华人|不|遵守|中国|法律法规|一律|驱逐出境
隔离|是|对|国内|人民|的|负责
国家|这么|做|也|是|顶住|了|很大|压力|组织|撤侨|很|难|啊|人太多|了
那些|移民|的|有钱|了|发财|了|都|跑|国外|了|出事|了|危机|了|都|跑|国内|了|你|还|真|以为|中国|是|你家|厨房|啊|想来|就|来|想|走|就|走|的|既然|外国|的|月亮|那么|圆|你|就|去|呼吸|外国|的|新鲜空气|吧|个人|言论|不喜|勿|喷
京彩|好|网民|只要|你|持有|中国|护照|祖国|都|会|像|你|敞开|怀抱|同样|今日|成果|来之不易|需要|我们|共同|维护|国门|为|同胞|而开|而|非为|病毒
可是|有些|人|不是|因为|这个|病毒|根本|就|不想|回来|当|呀
峰林|海涛|京彩|好|网民|只要|你|持有|中国|护照|祖国|都|会|像|你|敞开|怀抱|同样|今日|成果|来之不易|需要|我们|共同|维护|国门|为|同胞|而开|而|非为|病毒
原博|和|右边|说|得|都|非常|好|扩散|峰林|海涛|京彩|好|网民|只要|你|持有|中国|护照|祖国|都|会|像|你|敞开|怀抱|同样|今日|成果|来之不易|需要|我们|共同|维护|国门|为|同胞|而开|而|非为|病毒
我们|让|你|回来|是因为|你|是|祖国|一份|子|如果|你|不|珍惜|这|几个|月|的|成果|那|你|可以|哪|凉快|哪|呆|着|去|我们|没有|必要|惯着|你
人生|没有|尽善尽美|遇到|不合|心意|的|事情|就|当|是|一场|修行
一|听到|这个|bgm|就|想到|高以翔
可以|让|广东政府|也|紧跟|北京|步伐|吗
疫情|能|控制|住|是|全国上下|一起|努力|的|结果|你|既|认为|自己|是|国人|就|该|为|国家|好好|想想|积极|配合
看着|那些|为了|逃难|来到|中国|的|外籍华人|有些|真的|很|气愤|明明|就是|为了|躲|疫情|才|来|的|偏偏|觉得|自己|是|大爷|不|懂|一句|话|叫|人|在|屋檐下|不得不|低头|吗|麻烦|如果|想|有|什么|特权|那|你|还是|哪来|的|回|哪|去|吧|让|你|自己|的|国家|给|你|特权|请|记住|不是|我们|请|你|回来|的
不论|在|哪里|想起|祖国|总会|心安
不是|不|欢迎|只是|回来|的话|一定|要|报备|不然|会|有|很多|麻烦|要|浪费|很多|资源
今日|之|成果|来之不易|我们|必须|共同|守护|不可|瞒报|三元|三原
峰林|海涛|京彩|好|网民|只要|你|持有|中国|护照|祖国|都|会|像|你|敞开|怀抱|同样|今日|成果|来之不易|需要|我们|共同|维护|国门|为|同胞|而开|而|非为|病毒
只要|你|持有|中国|护照|祖国|都|会|像|你|敞开|怀抱
呕吐
国内|疫情|严重|他们|马上|走|自己|的|国外|国外|疫情|严重|马上会|国内|他们|都|是|社会|的|所谓|精英|他们|很|牛|逼|苦|逼|的|就是|普通|老百姓|国内|不管|如何|能|做|的|都|的|坚守|熬|下去|......|与|祖国|同呼吸共命运|到底|谁|是|这个|国家|的|主人|到底|谁|会|守护|这个|国家
危害|公共安全|判刑|罚款
即便|染疫|回家|也|不要|瞒报|不|做|病毒|帮凶|杜长军|头条新闻|/|峰林|海涛|京彩|好|网民|只要|你|持有|中国|护照|祖国|都|会|像|你|敞开|怀抱|同样|今日|成果|来之不易|需要|我们|共同|维护|国门|为|同胞|而开|而|非为|病毒
我|觉得|留学生|和|在|外国|的|华人|回国|都|是|正常|的|毕竟|中国|是|现在|最|安全|的|地方|但|因为|太|多媒体|抓住|个别|不良|案件|反复|通报|导致|现在|内地|人|很|反感|他们|回来|甚至|恶语相向|我|觉得|没|必要|毕竟|他们|是|我们|同胞|我|也|希望|媒体|能|做点|正事|不要|外|网|唯唯诺诺|国内|重拳出击
持有|中国|护照|中国|就是|家|无论怎样|家们|就|会|一直|敞开|着
北京|大门|对|湖北|籍|紧闭
看来|自费|医疗|主要|是|针对|移民|之后|想|回国|蹭|免费|医疗|的|那|批人|已经|放弃|中国|身份|了|当然|也|不让|他们|享受|权利
费用|自理|好
对|自己|负责|更是|对|他人|和|国家|负责</comments>