<source>专业版微博平台</source>
<title>#高福回应疫情初期在国际期刊发文章#</title>
<time>2020-4-23 20:50</time>
<url>https://weibo.com/2028810631/IEGNVB1aj</url>


<text>新浪|新闻|2020|4|23|20|50|来自|专业版|微博|平台|高福|回应|疫情|初期|在|国际|期刊|发|文章|新冠|肺炎|疫情|之初|中疾控|主任|高福|和|几十位|联合|作者|合著|了|两篇|文章|一篇|关于|新冠|病毒|科研|另|一篇|关于|疫情|的|发展|回顾|分别|发表|在|了|柳叶刀|和|新英格兰|医学杂志|两个|国际|著名|学术期刊|这个|做法|当时|引起|争论|当时|的|情况|科学家|是|应该|发|学术|文章|还是|应该|先|抗击|疫情|应该|在|国内|还是|国际|发|等等|在|接受|CGTN|专访|时|高福|对此|作出|回复|他作|了|个|猫和老鼠|的|比喻|病毒|是|老鼠|研究|人员|就是|猫|猫|发现|了|老鼠|还|不算|完|还要|搞清楚|一些|情况|他|说|科研人员|要|将|了解|的|情况|进行|公布|特别|是|在|国际|学术期刊|上|加以|公布|以|接受|全球|最|顶尖|同行|的|验证|和|质疑|peer|reveiw|这样|新|的|发现|才能|算数|他|说|当时|的|那|两篇|文章|并非|跨|时代|之作|但|其|内容|是|具有|意义|的|科学研究|和|描述|O|高福|回应|疫情|之初|在|国际|期刊|发|文章|高福|回应|疫情|之初|在|国际|期刊|发|文章|新冠|肺炎|疫情|之初|中疾控|主任|高福|和|几十位|联合|作者|合著|了|两篇|文章|一篇|关于|新冠|病毒|科研|另|一篇|关于|疫情|的|发展|回顾|分别|发表|在|了|柳叶刀|和|新英格兰|医学杂志|两个|国际|著名|学术期刊|这个|做法|当时|引起|争论|当时|的|情况|科学家|是|应该|发|学术|文章|还是|应该|先|抗击|疫情|应该|在|国内|还是|国际|发|等等|在|接受|专访|时|高福|对此|作出|回复|他作|了|个|猫和老鼠|的|比喻|病毒|是|老鼠|研究|人员|就是|猫|猫|发现|了|老鼠|还|不算|完|还要|搞清楚|一些|情况|他|说|科研人员|要|将|了解|的|情况|进行|公布|特别|是|在|国际|学术期刊|上|加以|公布|以|接受|全球|最|顶尖|同行|的|验证|和|质疑|peer|reveiw|这样|新|的|发现|才能|算数|他|说|当时|的|那|两篇|文章|并非|跨|时代|之作|但|其|内容|是|具有|意义|的|科学研究|和|描述</text>
<comments>不管怎么|洗|他|发现|人|传人|后|没有|及时|向|社会|发布|预警|总是|事实
开始|着手|洗白|了|吗
不是|评论|怎么回事|揪|着|本科|兽医|不放有|必要
闭嘴|吧
你们|要是|想锤|人家|就|干脆|拿出|视频|我敢|保证|这些|人|没|说|过|什么|不人|传人|的|绝对|话|他|最|多|说|过|暂时|没有|证据|显示|人|传人|绝对|是|你们|这些|普通人|一黑|即|黑|的|思维|就|理解|为|没有|人|传人|洗白|洗白|什么
从|没有|见过|如此|厚颜|无耻之徒|诸葛亮
不|信|兽医|了
他|怎么|还|在
有限|人|传人|可|防|可控|然后|跟|美国|的|什么|机构|发文|说|泪崩|因|啥事|泪崩|了|有没有|原文|可以|发出|来|看看|最|主要|是|要|留意|泪崩|的|时间|是|哪一天
毛主席|说|过|事实胜于雄辩|这|一句|话|就|把|这种|打着|科学|的|幌子|置|国民|生死|与|经济|于|度外|把|自己|的|虚名|利益|置于|前|没什么|好|解释|的|跟|你|发表|的|论文|内容|没有|关系|不要|偷换概念|跟|你|为了|发表|论文|而|隐藏|事实|有关|想|逃|你|是|逃不掉|的
我|算是|感受|到|自|媒体|和|营销|号|的|力量|了
术业|有|专攻|专业|的|事情|交给|专业|的|人|高中生物|都|没|学好|的|人|去|质疑|那些|奋战|在|病毒|研究|一线|的|科学家|勇气可嘉|笑话
当时|去|武汉|不是|去|防治|疫情|的|吗
和|发|文章|有|啥|关系|重点|难道|不是|有限|人|传人|和|跟|美国|打电话|哭|了|之间|的|矛盾|到底|是|高福|失职|还是|领导|决策|的|问题|吗|扯|这些|有|的|没|的|干嘛
兽医|专业人士
还|没有|下课
当听|高福|的|我|还|以为|不|传人|呢
除了|发|论文|好像|全程|隐身
这个|比|什么|时候|死|？|？
专家|就是|在|某一方面|有所|研究|的|人|论文|—|就是|在|某一方面|有所|建树|的|文章|世界|的|进步|离不开|他|它|们
臭狗
疫情|结束|了|你|出来|洗|白白|了|兽医
发|论文|没有|错|问题|是|作为|中疾控|主任|你|的|责任|呢
精利|主义者|不|适合|在|领导岗位|上|工作|误国|伤人
高|院士|1|月初|在|柳叶刀|上|发表|的|论文|公开|告诉|世界|新冠|病毒|会人|传人|所以|西方|甩锅|就|没有|了|根基
论文|贩子|第一|出发点|从来|没|放在|老百姓|身上
笑话|他|的|第一|职务|是|疾控中心|主任|还是|科学家|他|的|第一|责任|是|预警|控制|还是|写作|论文
他|为啥|还|没|下台|收监|？
无知|的|网民|太|可怕|了|我们|的|疾控中心|其实|就是|一个|研究|机构|根本|没有|实权|发声|只能|通过|学术论文|发声|真正|有|权利|的|是|卫健委
无耻|作为|国家|疾控|中|主任|元|月初|武汉|那么|多|医护人员|都|感染|了|还|不|采取|防|措施|央视|播报|新闻|说|没有|人|传人|也|不|及时|纠正|装聋作哑|最后|让|疫情|在|全国|传播</comments>