<source>iPhone 7 Plus</source>
<title></title>
<time>2020-1-23 10:48</time>
<url>https://weibo.com/1496883514/IqMYmf5Cf</url>


<text>凯雷|2020|1|23|10|48|来自|iPhone|7|Plus|已|编辑|医生|很|好|的|建议|强烈建议|取消|大年初二|周日|敬拜|活动|真的|希望|宗教局|的|相关|人员|能|意识|到|这件|事|的|严重性|不要|抱|侥幸心理|老师|我|是|一名|一线|医生|我|强烈建议|大型|集会|活动|能|取消|特别|是|宗教|活动|去|教会|的|大部分|都|是|老年人|新型|冠状病毒|现在|主要|以|老年人|患病|为主|一旦|患病|后果|不可估量|可是|大部分|老年人|都|觉得|事不关己|固执|不|听|劝阻|认为|病毒|不会|传播|到|自己|身上|放松|警惕|觉得|上帝|会|看顾|自己|强烈建议|取消|大年初二|周日|敬拜|活动|真的|希望|宗教局|的|相关|人员|能|意识|到|这件|事|的|严重性|不要|抱|侥幸心理|武汉|封城|##|全国|确诊|新型|肺炎|病例|##|湖北|主持人|戴|口罩|播报</text>
<comments>安全|第一|不要|再|搞|七七八八|了|🙏|🙏|🙏
老年人|真的|很|顽固|又|不|听|儿女|的|作为|儿女|们|都|太难|了|他们|什么|都|不|懂|也|不肯|戴|口罩|最后|害|的|是|一家人|啊
四川|这边|是|初二|全家|出动|去|公墓|上坟
大部分|老年人|都|觉得|事不关己|固执|不|听|劝阻|觉得|上帝|会|看顾|自己|强烈建议|取消|大年初二|周日|敬拜|活动|真的|希望|宗教局|的|相关|人员|能|意识|到|这件|事|的|严重性|不要|抱|侥幸心理
他们|要是|不去|求|上帝保佑| |给|他们|吃|再|多|药都|没用|的
到时候|狗|带|了|又|要|伤|医说|是|医生|没给治好|自带|雨伞
拜|个头
憨批|是|真多
让|爸妈|戴|口罩|比|爸妈|让|我们|穿|秋裤|还|难|/|木兮|ing|老年人|真的|很|顽固|又|不|听|儿女|的|作为|儿女|们|都|太难|了|他们|什么|都|不|懂|也|不肯|戴|口罩|最后|害|的|是|一家人|啊
神经病|吧|现在|还|搞|聚集|性|活动|？|卧槽
告诉|他们|死|的|都|是|岁数|大|的|人
劝不动|啊
各地|统战部|该|出马|了
我家|老人|也|是非|要|去|教堂|参加|宗教|活动|真心|希望|相关|机构|能|暂停|此类|活动
所有|的|交通|都|停|了|还要|聚会|脑残|还是|与|社会|做|对
南岳|大三|三十|那天|很多|人
真的|取消|吧|别搞|这些|乱七八糟|的|了
取消|吧|为了|安全|着想
都|取消|吧|任何|活动|前提|都|是|安全|第一
唉|有|的|人|迷信|呀|认为|拜|了|才|会|平安|这些|人|都|是|没有|什么|文化|的|人|很难说服|他们|的
目前|这种|状况|建议|政府|及早|颁布|居家|隔离|指南|因为|医疗|资源|严重不足|这是|显而易见|的|所以|一定|要|指导|轻症|患者|居家|隔离|将|对|自身|的|伤害|降低|到|最低|程度
没|那么|严重
可|老一辈|的|人|不|听|啊
武汉市|已经|取消|了|所有|公共场合|的|活动|寺庙|也|已经|公布|春节|期间|不|对外|了|请|不要|不看|新闻|乱|评论
根据|非必要|不|举办|原则|这项|宗教|风俗|活动|应该|取消
对|对|我家|都|是|有|信仰|的|之前|我哥|跟|老一辈|人|说|这次|肺炎|严重性|时|他们|认为|只要|自己|信|上帝|一定|会|保佑|自己|很多|人|就|这样|不戴|口罩|了|但是|感觉|这样|真的|很|危险|您|说|信|完全|没|问题|但是|不|一定|每次|都|是|上帝|亲自|来|救|您|啊|这么|说|口罩|这种|东西|就是|上帝|拯救|人类|用|的|啊|不戴|口罩|让|上帝|怎么|救|啊|！
他|都|信教|了|你|要|跟|他|讲|科学|难点
杭州|取消|了
现在|最|可怕|的|是|大量|的|武汉|返乡|人员|还|在|各处|活动|尤其|是|下面|县市|乡镇|里|来自|武汉|的|车辆|街上|到处|都|是|真该|拦住|他们|了
我|爷爷|就是|这样|在|村里|到处|转|那里|人多|哪里|串|大过年|的|打工|的|人|都|回来|了|叫|他|不要|出去|乱转|根本|不|听|一会|就|溜出去|了|我|直接|吼|这个|特殊|时期|染病|了|就|不是|某|一个|人|的|事|而是|一大家子|一群|人</comments>