<source>iPhone 7 Plus</source>
<title></title>
<time>2020-1-31 04:15</time>
<url>https://weibo.com/1496883514/IrXOzArxx</url>


<text>凯雷|2020|1|31|04|15|来自|iPhone|7|Plus|已|编辑|1|世卫|组织|发布|新型|冠状病毒|肺炎|疫情|为|国际|关注|的|突发|公共卫生|事件|2|但|中国|不是|疫区|中国|面临|远超|17|年前|非典|最|艰难|的|挑战|直面|的|是|保卫|武汉|斩断|疫源|守护|每|一个|人|的|健康|与|平安|3|今夜|面临|突发事件|挑战|的|中国|不是|孤岛|和|世界|仍|紧密|相连|我|和|我|的|粉丝|我|的|朋友|你|我|也|不是|孤岛|通过|微博|相联|渡过|这|漫漫长夜|一起|发起|一起|捐|9.9|元|长长|久久|施力|于|何处|1000|个|朋友|一起|定|齐心协力|帮助|武汉|助力|国家|渡过难关</text>
<comments>凯雷| |为什么|有些|博主|却|认为|是|坏消息|我|觉得|这|是|个|好消息
中国|这次|的|疫情|是|严峻|没错|性命攸关|的|事件|都|是|大|事件|但是|如果|从|国家|层面|出发|已经|被|西方|别有用心|的|那班|政府|渲染|得|太|过于|夸大|了|我们|中国|人|守望相助|民心所向|中国|战胜|这场|疫情|防控|狙击战|指日可待|让|那些|唱衰|中国|别有用心|的|人|死|了|这|条心|中国|加油|🇨|🇳
还|能|不能|正常|出国|啊|.........
愿|希望|与|光明|终|有|一日|再次|照耀|古老|的|华夏大地
已经|赞赏|9.9|心随|你动
感恩|第|141|位|朋友|/|岑今|月|落
武汉|加油
汶川|那年|我|怀着|真诚|的|心|把|我|所有|的|零花钱|自己|我|的|大部分|生活费|捐|了|出去|公布|捐款|用|向|却是|部分|人|中饱私囊|要|捐|也|要|捐|物资
世卫|本来|打算|两点|半|宣布|美国|突然|两点|半|宣布|发现|人|传人|然后|世卫|推迟|到|3|点半|发布|好好|想想|吧
凯雷|表示|中国|人民|众志成城|抗击|疫情|充满信心|1|世卫|组织|发布|新型|冠状病毒|肺炎|疫情|为|国际|关注|的|突发|公共卫生|事件|2|但|中国|不是|疫区|中国|面临|远超|17|年前|非典|最|艰难|的|挑战|直面|的|是|保卫|武汉|斩断|疫源|守护|每|一个|人|的|健康|与|平安|3|今夜|面临|突发事件|挑战|的|中国|不是|孤岛|和|世界|仍|紧密|相连
一|开始|带|节奏|说|自己|有|渠道|提前|知晓|了|结果|大肆|的|营销|然后|画风|一|转让|大家|一起|捐款|同样|作为|学|新闻|的|你|的|言论|太|没有|严谨性|了|还|主编|你|不是|说|WHO|没有|判定|吗|能|解释一下|你|的|打|脸|言论|吗
机制|三个|月|后|规则|自行|解封|如未|扭转|则|重新|审定|老米|之前|也|享受|过|同等待遇
什么|意思|大家|都|懂|没有|划|疫区|WHO|给|了|中国|面子|而已|哎
好消息|来|啊|加油|中国|加油|武汉
对|短期|国内|经济|而言|不是|个|好消息|会|有|一定|的|影响|但|对|解决|当下|的|疫情|问题|算是|个|好消息
中国|制造|遍布|全球|又|便宜|又|好|用|如果|改为|西方|本土|制造|人工成本|是|好几倍|像|澳洲|连|个|纸尿裤|厂|都|开|不|下去|成本|太高|了|一包|纸尿裤|原本|30|多|澳币|遇到|打折|还|能|更|便宜|让|本土|工人|开工|妥妥|的|加价|不然|还|能|压榨|工人工资|嘛
搞|什么|啊|你|这|人|有|毛病|吧|带|节奏|那么|欢|现在|又|来|搞|捐钱|。
已|举报
共度|难关
疫区|国|的|概率|就是|世卫|组织|的|突发|卫生|公共|事件|而|不是|比|突发|卫生事件|更|严重|的|才|叫|疫区|国|世卫|组织|已经|说|了|不|建议|对|我国|旅行|和|贸易|禁令|就|看|具体|到|每个|国家|对华政策|了|对方|国家|可以|不|当回事|也|可以|拿|着|鸡毛|当|令箭
被|紧急|的|原因|还是|因为|传染|到|了|其他|国家|尤其|是|医疗|水平|不行|的|国家
从|一|开始|就|不|相信|报道|的|事实|就|感觉|隐瞒|的|太|多|了
我|的|祖国|万岁|一定|会|挺|过去|的
各大|官方|新闻|媒体报道|世卫|组织|30|日|发布|新型|冠状病毒|感染|肺炎|疫情|为|国际|关注|的|突发|公共卫生|事件|强调|不|建议|实施|旅行|和|贸易|限制|并|再次|高度肯定|中方|的|防控|举措|这|背后|意味着|并|不|悲观
一|想到|那些|吃|野味|的|铁|憨|憨们|我|就|睡不着|越想|越气
现在|武汉|的|一线|医护人员|防护|设备|依然|紧张|武汉市|红十字会|和|慈善|总会|的|物资|发放|还是|不|及时|不|到位|期望|各位|广大|网友|积极|监督|督促
做好|自己|的|本分|共渡难关|我们|一定|会|赢|中国|加油
不管怎样|在|这样|的|情况|下|大家|众志成城|作为|我们|普通|民众|不要|给|祖国|添乱|祖国|依旧|是|我们|最|强大|的|母亲
捐|了|🙏
🙏|🙏|🙏</comments>