<source>专业版微博平台</source>
<title>#轻伤考拉被喂过量水死亡# 专家：喂水会导致致命肺炎</title>
<time>2020-1-15 10:25</time>
<url>https://weibo.com/2028810631/IpzoNcVMN</url>


<text>新浪|新闻|2020|1|15|10|25|来自|专业版|微博|平台|轻伤|考拉|被|喂|过量|水|死亡|专家|喂|水会|导致|致命|肺炎|据|报道|一只|被|轻微|烧伤|的|考拉|亚尼|在|得到|救治|后|伤势|逐渐|复原|只有|手脚|受到|轻微|烧伤|但|最后|却|因为|好心人|喂|它|太多水|而|死|于|肺炎|澳大利亚|动物界|野生动物|庇护所|在|社交|媒体|上|呼吁|正常|的|考拉|其实|不|需要|喝水|只|需要|进食|树叶|来|获取|水分|当|考拉|直接|仰头|喝水|并|摄取|过多|水分|时|水|可能|会|进入|它们|的|肺部|从而|引起|肺炎|这|对|它们|来说|相当|致命|L|沸点|国际|的|秒|拍|视频</text>
<comments>贷款|秒|下|周转|分期|借钱|芝麻|分|好心|办|了|坏事
只是|努力|生活|我|以为|澳大利亚|会|普及|考拉|的|相关|知识|呢|毕竟|有|那么|多|的|考拉
今日|宝藏|出发点|是|好|的|可惜
星岛|未晴|WB|这个|人|肯定|是|好心|的|以后|在|陌生|的|领域|还是|先|做好|调查|才|下手
小|虫虫|呀|好心|扮|坏事|还|摆|拍|唉|可怜|的|考拉|🐨
夢葉|发钱|寒|土澳|真的|要|科普|一下|考拉|野外|救援|了|要不然|下次|看到|要水|喝|的|🐨|救|也|不是|不救|也|不是
土豆泥|131|这|东西|比|熊猫|还|娇气|太难养|了|不过|有时|他会|突然|出现|在|你|身边|以|从天而降|的|方式
海派|甜昕|原来|是|这样|刚刚|才|看到|一个|考拉|喝水|的|视频
王半仙|吃|西瓜|有|一|说|一|我|去|我|也|喂|水|不看|这个|我特|么|都|不|知道|考拉|不|喝水
猫爵|么|么|我|觉得|是|各种|喂|水|视频|比较|多|误导性|比较|强|并且|没有|警示
X|南方|姑娘|min|之前|还|真不知道|现在|懂|了
花自|飘零|小|文文|这个|好心人|该|有|多|难过|啊
Monica|眈眈|那|考拉|为啥|喝个|不停
zzz|哦|是|吗|前|几天|看过|一个|新闻|一只|考拉|喝|了|7|个人|全部|的|水|关键|考拉|自己|真的|能|喝
荒诞|好不容易|逃出|生天|最后|死|在|这么|可笑|的|一件|事上
爪|爪|香不香|多|喂|肯定|是|我们|的|错|可是|它|明明|不渴|为什么|要|一直|喝|是|不好意思|拒绝|吗
hoperKE|祈福
Bodybodybodybow|用水|给|它们|浇|浇|身子
住进|龙哥|美瞳|里|的|大|可爱|那|怎么办|又|不能|喂|树叶
任梦旭|Flora|归根结底|都|是|国家|和|政府|在|这场|火灾|的|态度|导致|的|这种|局面|国家|领导|及|政府|不|作为
运气|爆棚|的|H|国家|一换|评论|过万
麻麻|我要|娶|她|烧伤|不能|大量|喝水|常识
马上|有人|鱼线|的|胖胖|考拉|今年|我|是|水火不容|啊
love|不见|烧|没|了
SIKI|私激|官方|微博|好心|做|了|坏事
噜|噜|啦|啦|HQ|早|科普|点|啊
盘腿|儿|坐|着|难受|话说回来|都|烧成|那样|了|哪|还有|树叶子|人|不|喂|水|更|得|死
巴卫|吖|W|天|哪|好心|办|坏事|哪位|好心人|该|多|伤心|啊
下山|扛|柴去
笨太|517|这个|还|真不知道|一般|都|会|喂|动物|喝水</comments>