<source>专业版微博平台</source>
<title>#海南确认4例新型肺炎病例#：患者均从武汉抵达海南</title>
<time>2020-1-22 16:18</time>
<url>https://weibo.com/2028810631/IqFHz7sMo</url>


<text>新浪|新闻|2020|1|22|16|18|来自|专业版|微博|平台|海南|确认|4|例|新型|肺炎|病例|患者|均|从|武汉|抵达|海南|22|日|国家|卫健委|确认|海南省|首例|输入|性|新型|冠状病毒|的|感染|病例|目前|海南省|共|确认|4|例|病例|均|为|输入|性|病例|4|例|患者|病情|平稳|体温|已|恢复正常|正在|定点医院|隔离|治疗|当地|卫生|健康|部门|已|对|其|密切接触|者|进行|追踪|随访|密切接触|者|目前|无|发热|等|异常|状况|人民日报</text>
<comments>影视剧|正太|天呐|武汉|的|别跑|了
妈咪|依依|19|强烈建议|加强|农村|偏远地区|的|宣传|从|全国|各地|返乡|的|都|很|有|可能|携带|病毒|这|两天|将会|是|春运|的|最高峰|农村|的|人|这方面|意识|比较|薄弱|很|有|可能|不|知道|病毒|的|可怕|所以|请|乡村干部|们|加强|病毒|的|防治|措施|加大|病毒|可怕|的|宣传|力度
加州|Jessie|那些|去过|武汉|的|不能|早点|去|医院|检查|吗|非要|等|感冒|了|就|去|医院|我们|县城|农村|老人|还|不|知道|这个|病是|啥|呢|这届|父母|真难|带
每日|甜份|要是|能|早点|控制|就|好|了
Eucalycotton|保佑|🙏|🙏|海南岛|也|要|注意|啊
小|核桃|的|悄悄话|春节|海南|要|接待|多少|游客|啊
喝咖啡|的|松鼠|爱|咋|咋|地|在|武汉|的|同胞|就|别往|出走|了
义乌|狂人|图片|评论|¡|评论|配图
成辰|---|you|封市|吧
bing|琥珀|武汉|的|别|到处|溜达|了
鱼|小|喵|喵|封城|吧
蔚山|朴勋|武汉|人|也|不想|待|在|武汉|还|能|怎么办
北北北北|be|要|保护|好|自己|减少|外出
与|速哥|同|在|希望|网警|时时|巡查|加强|网络|监管|对于|乱带|节奏|造谣生事|者|及时|抓捕|严惩不贷
逸心|驿站|能别|瞎|跑|吗|去过|武汉|和|武汉|的|...
一句|话入|你|心|祈祷|一切|安好
小泽|玛丽|怡|江苏|平安|武汉|加油
易拉罐|奶茶|武汉|过来|的|人|麻烦|戴好|口罩|😷|吧
森川|夏奈枝|一切|平安|🙏|🙏|🙏
星爷|很|强|gg
罒|本真|怎么|成|了|瘟疫|一般|全部|中招|来势汹汹
徐|笑闹|所有|病例|都|与|武汉|有关|建议|封城|吧|别|让|疫情|再|扩散|了
机智|小思洁|回复|蔚山|朴勋|武汉|加油|但是|目前|这种|情况|只能|委屈|你们|一下
玥|海|孤魂|这四人|想|避难|的|吗
一个|我|Cap|为什么|武汉|本地|没事|一|回老家|就|发病
顾墨珏|本来|约|好|走|海南|过节|的|现在|全部|取消|行程|都|在家|打麻将|算了
l|相思|思|愿|平安
一只|有|理想|的|咸猫|淦
鑫逸晕尘|武汉|人民|挺住|啊|但愿|全国|人民|都|平安
改个|id|不|被|发现|哦|豁|不|出门|了|不|出门|了</comments>