<source>专业版微博平台</source>
<title>人社部：企业不得开除因疫情影响上班员工</title>
<time>2020-1-24 14:41</time>
<url>https://weibo.com/2028810631/IqXVi0kYI</url>


<text>新浪|新闻|2020|1|24|14|41|来自|专业版|微博|平台|人|社部|企业|不得|开除|因|疫情|影响|上班|员工|人|社部|24|日|通知|明确|对|新型|冠状病毒|感染|的|肺炎|患者|疑似|病人|密切接触|者|在|其|隔离|治疗|期间|或|医学观察|期间|以及|因|政府|实施|隔离|措施|或|采取|其他|紧急措施|导致|不能|提供|正常|劳动|的|企业|职工|企业|应当|支付|职工|在此期间|的|工作|报酬|并|不得|依据|劳动|合同法|第四十条|四十|一条|与|职工|解除|劳动合同|在此期间|劳动合同|到期|的|分别|顺延|至|职工|医疗期|期满|医学观察|期|期满|隔离|期|期满|或者|政府|采取|的|紧急措施|结束|对|企业|因受|疫情|影响|导致|生产|经营|困难|的|可以|通过|与|职工|协商一致|采取|调整|薪酬|轮岗|轮休|缩短|工时|等|方式|稳定|工作岗位|尽量|不|裁员|或者|少|裁员|符合条件|的|企业|可|按规定|享受|稳岗|补贴|企业|停工|停产|在|一个|工资|支付|周期|内|的|企业|应|按|劳动合同|规定|的|标准|支付|职工工资|超过|一个|工资|支付|周期|的|若|职工|提供|了|正常|劳动|企业|支付|给|职工|的|工资|不得|低于|当地|最低工资|标准|职工|没有|提供|正常|劳动|的|企业|应当|发放|生活费|生活费|标准|按|各省|自治区|直辖市|规定|的|办法|执行|此外|因受|疫情|影响|造成|当事人|不能|在|法定|仲裁|时效|期间|申请|劳动人事|争议|仲裁|的|仲裁|时效|中止|从|中止|时效|的|原因|消除|之日起|仲裁|时效|期间|继续|计算|因受|疫情|影响|导致|劳动人事|争议|仲裁|机构|难以|按|法定时限|审理案件|的|可|相应|顺延|审理|期限|人民日报</text>
<comments>Aurora|lr|这种|关怀|政策|在|特殊|时期|必不可少
星岛|未晴|WB|希望|有点|人性|谁|也|不想|染上|这种|病
资深|艺人|经纪|张城豪|这个|要赞|一下
晴天|小小|猪|3|是|呀|谁|也|不想|生病|的|是|受害者|武汉|人|何尝|不是|99%|武汉|人|也|都|没|碰|野味|现在|都|成|了|全球|通缉犯|了
0|何事|秋风|悲画|扇|0|我敢|说|这|又|是|一个双|标|政策|肯定|绝大部分|人|是|享受|不到|的|他|想|辞退|你|有|一|千种|理由
薄荷|旅|国家|在|关键时刻|总是|那么|让|人|感动
兄|dei|这个|不错
呐呐|冉冉|纸上谈兵|国企|职工|过年|依旧|上班|却|没有|任何|补贴
猴猴|不吃|糖|家住|重庆|渝北区|过|完年|都|不想|回|重庆|了
陌今|赞|👍|🏻
嗨|李先森|如果|被|隔离|断|了|收入|银行贷款|按揭|什么|的|可以|出行|有待|政策|吗
暴走|的|水牛|出点|对待|恶意|隐瞒|病情|传染|的|对策|吧
南方|车站|等|胡歌|备注|一下|那些|贩卖|野味|和|吃|野味|得病|的|人|及其|家属|除外
三诺|葡萄糖|补水|液|大家|一定|要|注意|防范
橙子|味|烊|看看|江西|吧
XXXXIN|伟大|的|成功
yosan|人文|关怀
内娱|第一|倔强|柔弱|小白花|希望|真的|落实|吧
Angelia|521|不要|空喊|口号|如何|贯彻落实|监督|具体实施|劳动者|方|始终|是|弱势|的|一方|企业|想|开除|你|有|一百种|理由
生活|在|远远|远方|国家|给|国家|会|给|企业|补贴|吗
I|赵鑫鑫|这个|政策|真|好
又|一年|雪季|我|想|问问|租金|这里|有|补贴|吗|开|了|几家|实体店|看到|疫情|人|有点|晕
雨|打夏|王柯翰|Denzel
听风过|耳|ing|这个|要点|赞
喜喜|真的|不行|强烈建议|一线|的|各|医院|给|英雄|们|稳岗|补贴
sailor|灬|水手
M|夏|了|夏天|W|如果|劳动|仲裁|都|不管|用|怎么办
Soriss|好
奎大|爷爷|你|出钱
水瓶|lisa7|企业|不|一定|听</comments>