<source>专业版微博平台</source>
<title>#意大利首次确诊2例新型肺炎#，#中国往返意大利航空全部关闭#</title>
<time>2020-1-31 07:23</time>
<url>https://weibo.com/2028810631/IrZ3b0wrl</url>


<text>新浪|新闻|2020|1|31|07|23|来自|专业版|微博|平台|意大利|首次|确诊|2|例|新型|肺炎|中国|往返|意大利|航空|全部|关闭|意大利|当地|时间|1|月|30|日晚|意大利|总理|朱塞佩|•|孔特|和|卫生部长|罗伯托|•|斯|佩兰|萨在|罗马|向|媒体|表示|意大利|首次|确诊|两例|新型|冠状病毒|感染|肺炎|病例|据|意媒|报道|被|感染者|是|两名|中国|游客|此前|已|被|意大利|国家|传染病|研究所|医院|隔离|收治|目前|状况良好|其|曾经|留宿|的|酒店|房间|已|被|封锁|调查|人员|也|向|该国|卫生部|提交|了|初步|报告|孔特|表示|意大利|相关|部门|正在|对|两名|游客|入境|后|的|行踪|进行|仔细|确认|他|还|强调|收治病人|的|是|意大利|专业|机构|呼吁|该国|公众|无需|恐慌|同时|孔特|还|宣布|意大利|往返|中国|的|航班|已|全部|关闭|据|意大利|共和|报|及|安莎社|报道|两名|患者|为|一对|夫妻|来自|中国|武汉|分别|为|66|岁|和|67|岁|两人于|1|月|23|日|抵达|意大利|米兰|马尔|彭萨|机场|自|那|出发|前往|意大利|各省|游览|人民日报</text>
<comments>Cobalmelt|我|是|武汉|的|我|一直|都|在家|那些|武汉|到处|乱跑|的|我|也|没|办法|这|真的|是|素质|素质|还有|吃|野味|的|人|反正|这次|伤害|到|大家|和|国家|和|国外|的|我|也|恨|我|也|生气|请|大家|不要|地域|黑|我们|都|是|中国|人|大家|互相|帮忙|我|也|非常感谢|有|爱心|人士|和|幸苦|的|医护人员|和|国家|做|的|一切|一切|都|会|好|起来|的|好|了|以后|欢迎|大家|来|武汉|玩
爱萍|Wang|天|啊|😱|武汉|人|怎么|到|现在|还|满|世界|窜|安静|的|待|着|不行|吗
福橙橙|阿|乱跑|的|看看|吧|忍一忍|难道|过不去|么
依赖|shuo|都|那会|了|还|跑出去|干嘛|好好|在家|待|不行|吗|非得|把|全世界|都|感染|了|才|好|吗
粮食|在|冰冷|的|冬天|躲|在|地窖|里|请|让|他们|自己|付|在|意大利|的|医疗|费用|等|收到|账单|他们|会|打断|自己|那|两条|乱跑|的|腿
忌|廉蘇|打|気|水|1.23|号|出发|旅游|武汉|人|respect|热干面|牛|b|b|要|破音
芒果|优格|国际|影响力|啊|估计|很多|国家|不|和|我们|玩|了
Promise|Lyn|别|乱跑|了|在|家里|待|着|老婆|孩子|热|炕头|不香|吗
笑|清荷|不得不|再|高|看|咱|武汉|同胞|一眼
Rain67|我|在|意大利|留学|我|现在|朋友圈|和|我|一样|在|意大利|留学|的|朋友|全部|都|在|说|这件|事|他们|旅游|来|了|又|走|的|最后|遭殃|的|还是|我们|这些|留学生|现在|罗马|已经|有|了|好几起|意大利人|打|中国|人|的|事件|发生|了|他们|骂|中国|人|是|病毒|让|中国|人|滚回|中国|我们|现在|连门|都|不敢|出|甚至|罗马|音乐学院|已经|不让|中国|人去|上课|了
手|撕|丶|白莲|海外华人|又|要|被|当地人|歧视|了|这么|多人|筹钱|买|物资|寄|回国|结果|武汉|人|跑过来|送毒|败坏|所有|中国|人|的|声誉|连累|海外华人|也|要|被|当地人|排斥|这些|憨批|怎么|不死|在|半路上
从何说起|啊|i|你|很|丢人|诶|外国人|会|怨恨|中国|人|的
风瑞轩|2012|这些|老年人|不听话|是|真的
Anne|君怡|没事|瞎|跑|什么|传染|到|外国|对|我们|中国|来说|影响|也|很|不好
又|携|书剑|路|茫茫|23|日|还|他|妈|跑
W|哒|布六|身在|意大利|的|同胞们|现在|跟|过街老鼠|一样|拜托|了|能别|到处跑|了|家里|的|暖气|不暖|吗|家里|的|米饭|不香|吗
乏个|冰火|胜|自己|自|那|出发|前往|意大利|各省|旅游|这俩|tm|抛|出国|跑|就|跑|吧|还|各省|旅游|是|打算|靠|一己|之力|点亮|整个|意大利|中国|人|老脸|都|tmd|被|丢光|了|这次|艹
小|兲|念经|真他妈|服|了
clauaaa|kk|旅游|的|人|玩|几天|走|了|留下|无数|华人|在|意大利|受|影响|23|号|出来|还|到处|玩|的|人|你们|有心|🐎
往事|随风|yw|简直|就是|两个|祸害
Three|叁|叁|跑|嘛|安|不|安逸|嘛|香不香|嘛
爱|西瓜|的|大頭|猫|封城|那天|那个|点|之前|出去|的|哎封|的|还是|太晚|了|早些|听|院士|们|的|意见|就|好|了
城南|旧事|喜闻乐见|天天|听到|这|消息|阴云|笼罩|啊
梦里|和|许光汉|翻云覆雨|每天|醒来|都|是|新增|太|可怕|了
Yoyo|S|真的|很无语|了|因为|一些|没|素质|的|武汉|人|所有|武汉|人|背锅|我|和|先生|明天|要|去|意大利|出差|也|因为|这|两个|人害|的|全部|取消
闪电|劈|猪头|真|尼玛|服|了|这些|老头|老太|精力|比|我们|这些|上班族|要|好|的|多|平常|也|是|他们|这个|年龄层|的|精力|最|旺盛|抢|公交车|座位|天天|跟|上班族|挤|公交|挤|地铁|这|两个|货快|七十岁|的|人|了|还|尼玛|在|疫情|爆发|的|时候|出国|服|了|真的|服|了|我们|年轻人|没|这么|大|精力|每天|下班|只想|躺|着|刷|手机
叫|阿姨|不要|叫|姐姐|23|号|还|出游|这么|大|年纪
雪中翩舞|武汉|人能|不能不要|到处|乱跑|了
丶|風|月白|乱|地图|炮|的|你|必定|病从口入|多|的|不|说|不|费口舌
乐爱鱼|001|酒店|被|封太冤|了</comments>