<source>微博搜索</source>
<title></title>
<time>2020-4-15 23:58</time>
<url>https://weibo.com/3775056661/IDrKk3ZhE</url>


<text>巍岳钦禹|2020|4|15|16|40|来自|HUAWEI|P30|Pro|近日|金刻|羽|一篇|当下|时刻|中国|如何|赢得|全球|信任|文章|引起|讨论|文章|中有|两个|观点|一|美国|轻工业|能力|有限|中国|应该|把|棉签|呼吸机|口罩|等|防护|物资|送给|他们|并且|无条件|分享|关于|新冠|的|所有|研究|数据|二|疫情|的|大|流行|不是|吹捧|任何|一个|国家|的|治理|体系|或|方法|优越性|的|时候|更|不是|跟|美国|争夺|全球|主导地位|的|时候|而是|通过|帮助|他|国|赢得|信任|的|时候|我们|不用|考虑|战略意义|而|应该|考虑|道义|金刻|羽|女|生于|1982|年|哈佛大学|毕业|29|岁|成为|伦敦|政治经济|学院|最|年轻|的|宏观|经济学|终身|教授|其|是|前|财政部|副|部长|前|中金公司|董事长|现亚|投行|首任|行长|金立|群|的|女儿</text>
<comments>西方|会|用|行动|污蔑|她|国内|也|不会|接受|她
当代|汉奸
是|美国|在|不停|地|撕咬|中国|这|只|金蛋|小姐|说|是|奉献|自己|肉肉|的|时候|她|就是|这么|做|的
怪不得|亚|投行|办|的|不|咋|地|看来|他|爹|有|问题
凭|啥|你|想|舔|洋|你|去|别|撤|别人
又|是|一个|二|逼|方方
这样|的|女人|在|洋人|的|眼里|也|就|配|舔|舔|洋|屌|而已|没有|资格|对|中国|说三道四
卖国求荣|当代|川岛芳子
谁家|的|门|啊|居然|把|这|闺女|的|头|给|夹成|这样|是|美国|的|吧
这|是|的|伪|命题|吧|怎么|叫|信任|尤其|是|国际|关系|还|全球|一定|要|赢得|全球|信任|吗|南极|企鹅|不会|因为|你|做|什么|就|信任|你|吧|呆|蛙|也|是
涉藏|涉台|法案|干嘛|去|了|抽|你|一巴掌|还要|给|人|纸巾|擦手
要|不|这位|女士|先|把|自己|财产|捐|了|获取|一下|全球|的|信任
有关|部门|应该|查查|亚|投行|这些|年|的|办事|情况
她|自己|给|美国|人|捐|好|咯
我们|分享|研究|数据|时川|建国|说|只是|流感|民间|送|物资|时|他们|说|标准|不|合格|给|退|了|那|标准|既然|不|合格|就|说明|口罩|这个|标准|相对|于|中国|而言|还|算是|比较|高|的|应该|由|他们|这些|高精尖|的|国家|来|生产|我们|只好|自产自销|真是|不好意思|了
为了|拍|美国|马屁|把|亲爹|都|卖|了
有多远|滚多远
有|境界|有见|地|可惜|的|是|对牛弹琴
呵呵
转发|微博
官|二代
明白|了|意思|是|人家|打|了|我们|的|左|脸后|我们|应该|主动|把|右|脸|送|过去
这|逼|又|是|个|坑|爹|的|傻|孩子
她|为什么|不|把|她|爸|的|财产|全|送给|我|让|我|信任|她
政治|上|太|幼稚
是不是|已入|了|外籍
把|她|打包|送给|灯塔|国|即可
和|柴|有点像
这么|爱|舔|啊|你|自己|上|啊|不要|代表|我们
怎么|感觉|有点|大清|的|味道</comments>