<source>iPhone 7 Plus</source>
<title></title>
<time>2020-4-7 09:47</time>
<url>https://weibo.com/1496883514/ICbCGrQfi</url>


<text>凯雷|2020|4|7|09|47|来自|iPhone|7|Plus|广州|三元里|##|广州市|卫健委|回应|矿泉|街|境外|输入|疫情|密接|者|已|全部|隔离|检测|针对|社会|高度|关注|的|广州市|矿泉|街|境外|输入|病例|及其|本地|关联|病例|的|情况|4|月|7|日|广州市|卫健委|通过|媒体|对|排查|详情|进行|了|披露|3|月|28|日|30|日及|31|日|广州市|越秀区|疾控|机构|在|集中|观察|场所|先后|检出|5|例|非洲|籍|人士|核酸|阳性|均|为|尼日利亚|籍|皆|为|集中|医学观察|期间|筛查|发现|广州市|疾控|机构|开展|流行病学|调查|发现|上述|5|例|确诊|病例|中|有|4|人|曾|在|短时间|内|多次|到|越秀区|矿泉|街|美妙|美食|店|Emma|Food|用餐|餐厅|店主|庄某|及|员工|作为|密切接触|者|于|4|月|1|日|被|集中|隔离|医学观察|庄某|于|4|月|2|日|确诊|广州市|卫健委|表示|网媒|所说|24|日|病例|与|庄|某|并|无|关联|也|不是|揭阳|关联|病例|的|父亲|疾控|机构|根据|这|条|线索|进行|深入|流行病学|调查|通过|对|密切接触|者|追踪|和|发热|门诊|排查|发现|近日|报告|的|4|例|境外|输入|关联|病例|越秀区|3|例|白云区|1|例|共|甄别|出|197|名|密切接触|者|已|全部|实行|核酸|检测|集中|隔离|医学观察|O|广州市|卫健委|回应|矿泉|街|境外|输入|疫情|密接|者|...</text>
<comments>三元里|抗英|三元里|抗病毒|我|对|三元里|的|认知|太|肤浅|了|为什么|如今|成|了|外国人|的|天堂
真的|全部|隔离|了|吗|那|她|女儿|如何|传染|一个三岁|小孩|的|她|女儿|怎么|跑|去|揭阳|了
瑟瑟|发抖|🙏|我|的|大|广东
外国人|没有|医保|治疗|费用|怎么|算|让|全国|人们|买单|吗|他们|不|配合|不|隔离|乱跑|政府|打算|怎么|处理|我们|损失|了|那么|多|医务|工作者|全国|人民|为|疫情|付出|了|巨大|牺牲|和|努力|万一|被|他们|破坏|怎么办|早就|存在|的|隐患|一直|不|处理|，|现在|成|了|巨大|隐患
三非|不除|广东|一定|会|大乱|的
昨天|看|某大|V|否认|广州|黑人|问题|说|只有|三千个|黑人|而|有|网友|说|有|三十万|救救|广州|一直|听说|广州|尼哥|非法|滞留|问题|围攻|某某|所|要|身份|要|地位|闹事|都|有|有人|说|他们|落地|就|把|护照|一|撕|然后|黑|下来|所以|没法|遣返|有人|说|可以|让|他们|去|大西北|种树|问题|肯定|解决|方法|比|困难|多|都|懂|想|不想|解决|才|是|关键
该|对|这些|昆仑奴|失控|了|该|返返|没什幺|好|说|的|骨子里|欠|抽|你|把|它|当|牲口|用|可以|当人|猴穿|人衣|不|穿|还|像|人|穿|了|不|像|人|人权|不是|谁|都|有|的|该|治治|了
为什么|可以|在|集中|隔离|的|时候|外出|就餐
广州|市民|早就|在|疫情|前|好多年|都|在|投诉|那堆|非法|滞留|的|歪|果仁|可惜|Z|F|没|理会|疫情|发生|后|广州|市民|再次|大力|呼吁|要|管制|外来|病毒|入侵|可惜|Z|F|只是|自愿性|居家|隔离|.....|结果|就是|今天|的|结果|了|......
让|这些|黑人|回|自己|的|国家|吧
知道|这个|地方|来源于|三元里|抗英
广东|揭阳|发布|大家|对照|凯总|这条|微博看|凯雷|广州|人民|想|早日|开学|早日|复工|复产|小孩子|不能|平安|上学|整天|在家|需不需要|家长|照看|家长|也|是|需要|到|外面|谋生|的|¡|评论|配图
和|店主|接触|过|的|呢
凯雷兄|建议|大公|新华|人民日报|凤凰|之类|下沉|到|广州火车站|周围|三|公里|实地|调研|一下|还有|广州|周边|100|公里|内|的|城市
法律|面前|人人平等|每个|人|都|要|遵守|不|遵守|中国|法律法规|外国人|让|他们|离开|难|吗
广州|三元里|在历史上|可是|有|抗击|英军|入侵|的|光辉|事迹|的|在|今天|却|没|办法|把|非法|入境|非法|居留|非法|务工|的|外籍人士|撵出去
晚上|到|三元里|和|电视塔|后面|👀|就|知道|有|多少|黑
要么|遣返|要么|去|挖煤|要么|去|西北|种树|三选|一
新闻|哈哈哈|.....|事情|发生|在|瑶台|村|却|把|三元里|村|摆|上台
三元里|附近|还有|传要|建|方舱|了|可|想|疫情|严重性|我|是|不信|觉得|夸张|可|政府|能|出来|解释|个|清楚|吗|再|遮遮掩掩|也|难怪|我们|都|要|相信|传言|了
京沪|广|的|压力|越来越|大|更要|坚持不懈|的|继续|强力|组织|抗疫|否则|会|前功尽弃|的
黑祸
但是|热|搜|看起来|很|严重
三元里|滞留|的|一帮|乱糟糟|的|什么|玩应|渎职|啊
没|明白|他们|去|餐馆|是|集中|隔离|之前|还是|集中|隔离|过程|中|跑出去|了|如果|是|集中|隔离|之前|那|说明|是|有|了|症状|去|隔离|的|那|他们|的|病|是|谁|传染|的
关键|是|对于|非法|入境者|必须|全部|驱逐|并|严打
对|广州|黑人|的|管理
强烈要求|遣返|非法|滞留|者|不论|肤色|非法|的|就是|不行|偷渡|的|也|不行
非法|滞留|者|谁|出钱|治疗
世界|公交车|是|什么|意思</comments>