<source>iPhone 7 Plus</source>
<title>WTI 5月原油期货收报-37美元/桶，历史上首次收于负值，病毒、信息、货币，全球村步入第三次世界大战</title>
<time>2020-4-21 02:58</time>
<url>https://weibo.com/1496883514/IEgVLqjRi</url>


<text>凯雷|2020|4|21|02|58|来自|iPhone|7|Plus|已|编辑|WTI|5|月|原油期货|收报|37|美元|桶|历史|上|首次|收于|负值|病毒|信息|货币|全球|村|步入|第三次|世界大战|WTI|即|West|Texas|Intermediate|Crude|Oil|美国|西|德克萨斯|轻质|中间|基|原油|是|北美地区|较为|通用|的|一类|原油|由于|美国|在|全球|的|军事|以及|经济|能力|WTI|原油|已经|成为|全球|原油|定价|的|基准|而|为|统一|国内|原油|定价|体系|美国|以|NYMEX|纽约|商业|交易所|上市|的|WTI|原油|合约|为|定价|基准|病毒|信息|货币|是|新闻学|框架|里|的|三|元素|波动性|.......|历史性|的|呈现|........|我|.......|第三次|世界大战|.......|见证|了|太多负|历史|全球|村|已|步入|第三次|世界大战|第一次|工业革命|带来|了|一战|第二次|工业革命|带来|了|二战|第三次|全球|村|带来|了|第三次|世界大战|与|新冠|疫情|特洛伊木马|sars|cov|2|之战|病毒|信息|货币|是|新闻学|框架|中|的|三|元素|更是|第三次|世界大战|的|核心|三|元素|它们|都|与|全球|村|的|流动性|相关|与|一战|二战|相反|前|两次|世界大战|直接|促成|了|病毒|信息|货币|的|更|高|维度|的|流动|三|战|直接|由|第一|元素|病毒|构成|第三次|世界大战|的|解决|与|一战|二战|最大|的|区别|就|在于|熔断|第一|元素|病毒|的|流动性|让|信息|货币|以新|的|方式|重新|流动|起来|等到|2020|年|到来|大家|终于|发现|那些|时髦|的|人工智能|经济学家|写手|弗里德曼|尤|瓦尔|•|赫拉|利|的|人类|简史|它们|每天|预言|的|未来|真是|全部|是|重演|一次|历史|与|地球村|的|未来|与|危机|毫无关系|他们|提供|不了|地球村|的|预警|与|未来|图谱|它们|提供|给|我们|的|不是|不确定性|本身|它们|几乎|和|诗歌|宗教|一样|提供|的|是|不确定性|到来|的|前|一种|现实感|的|安慰|/|轻风|细雨|大叔|小号|只能|这么|说|病毒|是|三战|的|开端|第三次|世界大战|##|三战</text>
<comments>我|觉得|应该|不是|每桶|倒|搭|37|美元|到底|每桶|多少|钱|谁|告诉|我|这|又|对|世界|有何|影响
是|美国|搞|得|事情|沙特|和|俄罗斯|这些|国家|希望|控制|在|15|美元|左右|这样|即能|搞|死|美国|页岩|油|又|能|保证|自己|不|赔本|现在|这|情况|绝对|是|美国|在|操纵|价格|这|等于|沙特|和|俄罗斯|不让|美国|好|美国|也|不让|其它|人好|直接|干到|赔本|这样|大家|都|撑|不了|多久|赔本|卖|谁|卖|的|多|谁|赔|的|越|多|当然|了|美国|成本|是|最高|的
你|有|地儿|放|出得|起|运费|仓储|费|人工费|你|就|拉走|问题|是|那边|仓库|都|满|了|仓储|成本上升|有|交割|权限|的|也|没|交割|能力|了|市场|上|一帮|抄底|的|很多|对|规则|都|不|了解|不|知道|今天|到期|不|知道|还|能|跌破|零|现货|商在|期货市场|逼死|多头|见|过空|逼|多|逼成|负值|第一次|活久见|2020|果然|不|一般
上天入地|开脑|换心|曾|以为|无所不能|却|败给|了|肉眼|看不见|的|病毒
/|绿色|信徒|臻|你|有|地儿|放|出得|起|运费|仓储|费|人工费|你|就|拉走|问题|是|那边|仓库|都|满|了|仓储|成本上升|有|交割|权限|的|也|没|交割|能力|了|市场|上|一帮|抄底|的|很多|对|规则|都|不|了解|不|知道|今天|到期|不|知道|还|能|跌破|零|现货|商在|期货市场|逼死|多头|见|过空|逼|多|逼成|负值|第一次|活久见|2020|果然|不|一般
买|一桶|倒|送|40|是|几个|意思
对|国内|来说|桶|价|又|暴涨|了
抱歉|看不懂|了|啊|负数|是|什么|意思|啊
快去|睡觉|吧
活久见|事出|反常|必有|妖
凯记|您|的|知识面|好|宽|语言|组织|力|也
WTI|5|月|原油期货|收|37|美元|桶|史上|首次|收于|负值|病毒|信息|货币|全球|步入|第三次|世界大战|美国|西|德克萨斯|轻质|中间|基|原油|是|北美地区|通用|的|一类|原油|由于|美国|在|全球|的|军事|及|经济|能力|WTI|原油|已经|成为|全球|原油|定价|的|基准|而|为|统一|国内|原油|定价|体系|美国|以|纽约|商业|交易所|上市|的|WTI|原油|合约|为|定价|基准| 
战争|的|阴云|越来越|厚|了
最新|确认|是|交易|系统故障
这|怎么|理解
这个|世界|不|太平
油价|负数|意味着|将|油运|送到|炼油厂|或|存储|的|成本|已经|超过|了|石油|本身|的|价值
中行|到期|轧差|的|价格|是|以|几点|结算
转移|矛盾|战争|要|不|整个|石油|产业链|垮掉
卖方|不仅|免费送|石油|还|负责|把|买方|的|运费|给|支付|了
晚安|凯哥
什么|时候|房价|这样|就|好|了
第一次|见
WTI|原油|如何|操作|我|不|知道|只|知道|国内|期货|在|开多仓|的|时候|有个|选项|选|交割|买定离手|月末|交割|选|投机|月末|强平|这是|投机|仓强平|的|结果|吧|交割|大佬|们|后悔|没|最后|一天|买货|了|吧|但|怎么|出来|的|负值|有点|奇怪
关注
沈阳|那个|高空|抛物|的|事件|上|了|热|搜|本想|去|沈阳|公安|底下|评论|一下|结果|发现|我|竟然|被|市局|的|官|微拉黑|了
见证|历史|多因|归|一
转发
一个|小时|的|时间|WTI|价格|如|黑云压城城欲摧|啦
!|!|!|!</comments>