<source>iPhone 7 Plus</source>
<title>广州星巴克一员工诊断为疑似病例，附近居民进行核酸检测</title>
<time>2020-4-19 17:19</time>
<url>https://weibo.com/1496883514/IE3Iag941</url>


<text>凯雷|2020|4|19|17|19|来自|iPhone|7|Plus|已|编辑|星巴克|一例|新冠|阳性|广州|也|是|通衢|要|地|防控|形势|复杂|文|未有|一条|广州|卫健委|的|问答|相当|及时|负责|广州|星巴克|一|员工|诊断|为|疑似病例|附近|居民|进行|核酸|检测|广州|星巴克|好|世界|广场|店|一名|员工|诊断|为|新冠|肺炎|疑似病例|附近|居民|4|月|19|日可到|指定|地点|进行|核酸|检测|现场|十几名|身着|防护服|的|医务人员|正在|有序|的|为|排队|人员|进行|检测|现场|工作人员|介绍|该|检测点|主要|面向|建设|六|马路|的|社区|居民|和|好|世界|广场|的|员工|新快报|记者|夏世焱|广州|卫健委|问答|相当|及时|负责|健康|广州|因对|医学|专业术语|的|理解|偏差|所致|核酸|检测|阳性|包含|无症状|感染者|与|确诊|病例|/|/|阿宋|嘻嘻|嘻|新快报|今天|报道|新世界|广场|星巴克|员工|疑似|但|今天|和|昨天|都|公布|的|零|疑似|是|怎么回事|呢|是|新快报|造谣|还是|未|公布|广州|星巴克|一|员工|诊断|疑似病例|##|广州|一|星巴克|发现|疑似病例|L|新快报|的|微博|视频</text>
<comments>广州|星巴克|一|员工|诊断|为|疑似病例|附近|居民|进行|核酸|检测|广州|星巴克|好|世界|广场|店|一名|员工|诊断|为|新冠|肺炎|疑似病例|附近|居民|4|月|19|日可到|指定|地点|进行|核酸|检测
现场|十几名|身着|防护服|的|医务人员|正在|有序|的|为|排队|人员|进行|检测|现场|工作人员|介绍|该|检测点|主要|面向|建设|六|马路|的|社区|居民|和|好|世界|广场|的|员工|新快报|记者|夏世焱
健康|广州|因对|医学|专业术语|的|理解|偏差|所致|核酸|检测|阳性|包含|无症状|感染者|与|确诊|病例|/|/|阿宋|嘻嘻|嘻|新快报|今天|报道|新世界|广场|星巴克|员工|疑似|但|今天|和|昨天|都|公布|的|零|疑似|是|怎么回事|呢|是|新快报|造谣|还是|未|公布
有|知情|群友|出来|说|下|是|确诊|了|吗
建设|六|马路|周围|老外|多
开业|的|店里|员工|是不是|没|做|双向|检查
花园酒店|白云|宾馆|那里|淘金|地铁站|出口|老外|多|属于|老|市中心|位置|了
期待|疫苗|早点|研发|生产
排|的|队|有点|紧凑|啊| |注意|社交|距离
年|后|感觉|广州|现场|卫控|是|不是|我|的|地盘|我|不管|我|可以|不管|我|就|不管|电话|举报|都|不|去|彻底|追究
荔湾区|康王路|也|是|这样|了
还|想|去|广州|天河|棠|下|那里|见|未来|丈母娘|探讨|彩礼|钱|呢
这地|离|我|学校|也|太近|了|吧|我|下个|礼拜|就|回去|了
广州|管理|太|差
我|有|个|疑问|核酸|检测|人员|一直|不|换|手套|就|一个|一个|接着|把手|伸|到|检测|者|的|口腔|里|没有|交叉感染|的|风险|吗
作为|广州|人|是|欢迎|这种|杯弓蛇影|疑神疑鬼|的|讨论|这样|才能|不|放松|防疫|但|也|不至于|一些|人|嘴里|的|制造|的|言语|来|的|恐怖|广州|疾控|流调|的|工作|是|深入|的|不要|抹杀|政府|的|和|基层人员|的|大量|的|辛苦工作|网上|的|一些|言论|连|我|这个|路人|都|觉得|别有用心|了|我|也|从|我|的|理解|谈|一下|政府|的|发布|我|认为|政府|发布|基本|准确|的
广州|广州
每天|接触|那么|多|不|认识|的|客人|员工|也|是|不|容易
之前|就|有|员工|确诊|了|让|先|离职|好|了|再|回来|就是|怕|这种|新闻|不要|问|我|为什么|知道|是|我|朋友
严防死守|北防|回流|南防三非
论|这个|确诊|病例|是|在|可控|范围|内|吗
这个|病毒|真的|不是|说|没|了|就|没|了|的|其他|城市|的|星巴克|也|要|慎重|了
都|是|进过|星巴克|的|不过|这一波|做|的|不错|👍
转发|微博
完
外来人|太|多
一个|人|害死|一群|人
凯叔|把|文末|误|写成|文未|是|由于|用|了|手写输入|法|还是|其他|非|拼音输入|法
为了|面子|害|了|里子
壹壹|Vinia</comments>