<source>iPhone 7 Plus</source>
<title></title>
<time>2020-4-7 21:46</time>
<url>https://weibo.com/1496883514/ICcNK1aLn</url>


<text>凯雷|2020|4|7|12|47|来自|iPhone|7|Plus|地球村|很|危险|只能|记者|先|呼吁|起来|英国|还有|局部地区|实施|群体|免疫|不允|戴|口罩|怕|吓|着|人|新加坡|佛系|抗疫|是|伪饰|泡沫|瑞典|国不|认真|抗疫|已|是|前车之鉴|凤凰|倪晓雯|霜叶|的|文章|这|是|我|迄今|见到|全球|村|疫情|讲得|最|一目了然|的|每日|一|更|值得|朋友|们|关注|有|以下|10|个|国家|特别|可怕|1|早晨|从|中午|开始|西班牙|刚|睡醒|正|联络|北京同仁医院|招募|中国|医护|之前|听|我|的|从|这个|浪漫|国度|三月初|逃回|中国|的|留学生|上周末|起|不停|的|感谢|我|出国|的|留学生|并非|大家|假想|的|都|是|纨绔子弟|和|我们|一样|远走|异乡|都|是|想|避开|拥挤不堪|的|高考|独木桥|今天|回到|中国|才能|最低|成本|保命|2|马来西亚|瑞典|厄瓜多尔|在|爆雷|3|菲律宾|印度|新加坡|还|在|佛系|抗疫|4|美英|法|还|在|实施|绥靖|政策|它们|还|不|清楚|这是|第三次|世界大战|它们|误判|中国|是|对手|老|提防|着|遥远|的|国度|令新冠|特洛伊木马|直接|突破|欧美|海防|攻城|康不德|L|凯雷|的|微博|视频</text>
<comments>3|菲律宾|印度|新加坡|还|在|佛系|抗疫
2|马来西亚|瑞典|厄瓜多尔|在|爆雷
4|美英|法|还|在|实施|绥靖|政策|它们|还|不|清楚|这是|第三次|世界大战|它们|误判|中国|是|对手|老|提防|着|遥远|的|国度|令新冠|特洛伊木马|直接|突破|欧美|海防|攻城|康不德
老凯|感觉|您|是|过于|恐慌|了|英国|人口|超过|6600|万|每年|必须|正常|死亡数|约|66|万|您|明白|这个|数是|怎样|得来|的|吗|现在|这个|疫情|英国|死亡数|不|0.6|万|并且|大多数|都|是|老人|和|有|基础|病|的|占|每年|必须|死亡数|的|比例|不到|百分之一|目前|这样|的|死亡率|你|要求|英国|那么|恐慌|做|什么|这|不是|您|在|添乱|吗
英国首相|由|轻度|症状|到|现在|进入|ICU|还|没有|击破|那些|国家|群体|免疫|的|幻想|吗|？|正视|现实|吧|积极|组织|全民|抗疫|遵循|不|聚会|不|聚餐|不|聚会|的|三|不|抗疫|原则|！
哥|能|不能|先|让|自己|活过来
我|估计|下|一个|爆发|点|在|印度
谢谢|凯雷|总帮|转|还好|这|世界|上|大多数|记者|头脑|是|清醒|的|听话|待家|吧
还是|要|看到|一些|积极|的|东西|韩国|确诊|数|50|以下|了|其中|还有|相当|部分|境外|输入|型|意大利|和|西班牙|确诊|数都|在|下降|未来|多|一个|国家|控制|住|了|就|多|一个|国家|给|其他|国家|援助|口罩
凯雷哥|咱|这|头像|能|换回|彩图|吗
无症状|太|可怕|排毒|完毕|才|有|症状
世界大战|的|说法|没错|只是|各国|的|对手|只有|一个|那|就是|新冠|病毒
第三次|世界大战|这个|定位|太|准确|了
英国首相|都|进|icu|这个|还|不够|惊悚|害怕|吓|着|人
非常|敬佩|你|在|中国|爆发|期间|的|大声疾呼|但是|到|了|下半场|报道|国外|疫情|的|时候|个人感觉|非常|low
欧洲|什么|时候|能|结束|10|月份
美英|法|还|在|实施|绥靖|政策|它们|还|不|清楚|这是|第三次|世界大战|它们|误判|中国|是|对手|老|提防|着|遥远|的|国度|令新冠|特洛伊木马|直接|突破|欧美|海防|攻城|康不德
没|回来|的|美国|的|小|留学生|受苦|了|相信|使馆|会|有|帮助|/|凯雷|美英|法|还|在|实施|绥靖|政策|它们|还|不|清楚|这是|第三次|世界大战|它们|误判|中国|是|对手|老|提防|着|遥远|的|国度|令新冠|特洛伊木马|直接|突破|欧美|海防|攻城|康不德
凯叔|看到|广州|三元里|的|几十万|黑人|同胞|事件|也|很|焦虑|啊|也|不|知道|有|最新|的|确切|信息|吗
不|老老实实|抄|作业|下场|就是|➡|️|🇺|🇸
西班牙|招募|中国|医护|？|？|这|是|闹|哪样
这个|病毒|专治|各种|不服|啊
可|他们|说|股市|牛市|了
森林|里|的|鹿|与|蓝精灵
台湾|控制|的|很|好|啊|怎么|没什么|新闻报道|呢
不|以|口罩|为|手段|的|防疫|都|是|流氓|骗子
头像|能|换回来|吗|认真|脸
转发|微博
操好|自己|的|心|管好|自己|让|自己|平静下来|才|是|最|重要|的
全球|命运|共同体</comments>