<source>微博 weibo.com</source>
<title>#泰国回应向中方求助后又向美国出口口罩#</title>
<time>2020-3-26 18:02</time>
<url>https://weibo.com/1618051664/IApJIiKhf</url>


<text>头条新闻|2020|3|26|18|02|来自|微博|weibo|com|已|编辑|泰国|回应|向|中方|求助|后|又|向|美国|出口|口罩|泰国|驻华|大使馆|就|中国|多家|媒体报道|泰国|向|中方|请求|医疗|物质|援助|后|又|向|美国|出口|大量|口罩|一事|的|声明|1|新闻报道|的|内容|存在|差异|且|未|指出|部分|事实|1|在|中国|表示|中方|有|能力|给予帮助|的|基础|上|泰国政府|接受|了|中国|的|医疗|物资|援助|2|在|中国|遭受|新冠|肺炎|疫情|严重|影响|期间|泰国|向|中国|捐赠|了|资金|及|包括|口罩|在内|的|医疗|物资|和|设备|以|援助|医护人员|和|受|新冠|肺炎|影响|的|人民|不过|在|那段|期间|其实|泰国|也|已|开始|面临|医疗|物资|尤其|是|口罩|短缺|的|情况|但|泰国|依然|基于|中|泰|紧密|关系|和|人道主义|精神|对|中国|施以|援助|2|随后|泰国|的|新冠|肺炎|疫情|日益严重|导致|口罩|等|医疗|物资|匮乏|泰国政府|竭力|采购|并|加大|了|口罩|生产力|以|保障|泰国|内需|但|由于|口罩|需求量|持续上升|故|仍|处于|短缺|状态|因此|中国政府|作为|泰国|的|老朋友|和|全面|战略|合作伙伴|向|泰国|表达|了|友好|心意|并|施以援|手|给|泰国|捐赠|了|医疗|物资|并|协调|沟通|让|泰国|能|从|中国|采购|更|多|的|医疗|物资|和|原材料|泰方|十分|感谢|泰国|卫生部|将|把|中方|捐赠|的|医疗|物资|分发|至|泰国|医护人员|手中|3|至于|泰国|将|部分|口罩|出口|至|国外|一事|是因为|泰国|在|近|几十年|来|开放|接受|外商投资|因此|在|泰国|存在|部分|前来|投资|把|泰国|作为|口罩|生产|基地|将|生产|的|口罩|运回|自己|国家|第三方|国家|进行|销售|的|外国|企业|尤其|是|以|代工|生产|或称|OEM|Original|Equipment|Manufacturer|的|生产|形式|居多|所以|导致|这部分|口罩|不|可以|在|泰国|国内|销售|因为|是|版权|商品|而且|多家|公司|还|享受|泰国|投资|促进|委员会|BOI|的|优惠政策|获得|了|零关税|进口|原材料|进行|生产|并|出口|的|权利|如果|在|国内|销售|则|不会|享有|上述|权利|因此|在|泰国|国内|口罩|短缺|的|情况|下|泰国|准许|上述|口罩|生产|公司|将|口罩|出口|到|国外|一事|是|按|上述|提及|的|法律|承诺|实施|的|泰国|驻华|大使馆</text>
<comments>.....|大家|消消气|这种|是|没|办法|的|作为|代工|地|OEM|的|这种|确实|只能|出口|国家|不光|说|了|不算|这时候|也|不敢|发声|国内|很多很多|代工|行业|也|是|这样|不能|在|本国|销售|所以|拥有|自有|工业|真的|是|重要|啊
评论|的|能|不能|把|新闻|看|完|再|开始|杠|....|一天天|的|你们|不累|吗|.....
有意思|欧美|都|是|禁止|医疗|物资|出口|或者|扣押|别国|物资|泰国|一边|求助|物资|援助|一边|出口|物资|两不误
建议|将|援助|不同|国家|的|口罩|打|上|不同|的|印记|想|看看|这些|口罩|最后|流向|了|何方
呵呵|如果|真|缺口|罩|怎么|可能|允许|出口|看看|欧洲|国家|别说|出口|不行|还|抢|别人|的
懂|了|就是|我们|很|缺口|罩|就是|没|胆子|截美爹|的|胡
顺着|这个|意思|理解|就是|作为|代工厂|生产|的|口罩|等|医疗|物资|不能|留在|本国|要|出口|给|美国|🤔|🤔
礼尚往来|我们|做好|自己|问心无愧|即可|没|必要|也|没|权力|指责|其他|政府
那|人情|还|了|没有|以后|了
这次|抗击|疫情|谁|人|道|谁|甩|锅|一清二楚|别|睁眼瞎
这波|操作|第一条|看着|就|不|舒服|而且|可能|因为|敷衍了事|越描越黑
反正|从来不|去|泰国
意思|就是|我|泰国|国内|真的|不够|用|你|中国|给|我|的|都|发放|医护|了|我|泰国|无权|要求|外资企业|不|生产|出口|口罩|要|尊重|法律|精神|其实|非常|时期|是|可以|强制|禁止|口罩|出口|的|毕竟|要|先|保障|泰国|国内|够用
既然|短缺|怎么|不|管制|扣留|呢
投机倒把
他|的|意思|是|中国|说|要|给|我们|的|而且|我们|之前|也|给|过|中国|的|给|美国|口罩|的|不是|泰国|公司|所以|这|口罩|你们|得|给|我们
疫情|严重|就|应该|医疗|物资|管制
辟谣|范文
总结|一下|1|泰是|我们|的|朋友|疫情|开始|期间|给|我国|捐献|部分|口罩|2|泰|顶不住|美帝|的|压力|需要|把|部分|国内|生产|的|口罩|出口
借花献佛
还有|这|操作
评论|真是|看|都|不|看|就|开|骂
人家|说|的|一点|毛病|都|没有
唉呀|网友|同胞们|礼尚往来|懂不懂|啊|从小|都|是|什么|家庭教育|啊
这种|运回|本国|售卖|的|商品|能|叫|出口|吗|不|懂|虚心|请教
呵呵
泰文|版|日期|都|是|2563|年|了|阿拉伯数字|不|都|是|全球通|用|吗|且|日期|也|是|全球通|用|吧|难道|泰国|比|我们|领先|了|500|多年
德国|你|怎么|不|学学|我
学|德国|截|了|它
这是|援助|给|你们|自己|用|的|又|不是|给|你们|去|销售|的</comments>