<source>微博 weibo.com</source>
<title>现场！#特朗普称美国死亡率两周内达高峰#</title>
<time>2020-3-30 07:29</time>
<url>https://weibo.com/1618051664/IAXiT9SAo</url>


<text>头条新闻|2020|3|30|07|29|来自|微博|weibo|com|现场|特朗普|称|美国|死亡率|两周|内达|高峰|截至|美|东|时间|3|月|29|日|下午|6|时|美国|新冠|病毒感染|病例|近|14|万|累计|死亡|2436|例|形势|十分|不|乐观|面对|严重|疫情|美国|总统|特朗普|宣布|多个|州|进入|灾难|状态|并|出席|记者会|报告|情况|特朗普|表示|越来越|多|美国|人|在|付出|努力|美国|的|死亡率|将|在|未来|两周|达到|高峰|L|海客|新闻|的|秒|拍|视频</text>
<comments>这次|的|病毒|有三大|特点|一|特|特殊|之前|大家|都|没见|过|二|没|能够|到处|传播|特别|没色|没味|三|普|普遍|男女老幼|都|可|感染|所以|这个|病毒|我们|可以|命名|为特|没普|病毒
资本|放任|了|新冠|新冠|反噬|了|资本|雪崩|之前|每|一片|雪花|都|在|勇闯|天涯
如果|早点|采取措施|不至于|到|现在|这种|局面
特朗普|真的|是|罪人
尘归尘|土归土|喊|我|一句|特朗普
14|万|即使|这样|也|不|隔离|封城|隔离|自由|没|了|人权|没|了|不|隔离|人|没|了|这|就是|所谓|的|西方式|民主
没人|比|我|更|懂|病毒|真的
中国|人们|这下|我们|看清|了|社会主义|和|资本主义|哪个|是|为民请命|的|了|啊|吧|社会主义|核心|价值观|和|西式|自由民主|人权|论|哪个|是|真正|的|人民|当家做主|了|吧|中国|国内|即使|有|各种各样|的|问题|可是|做|中国|百姓|远|比做|美国|百姓|更|踏实|更|安全|更|幸福|了
美帝|每天|几万|增速|几百万|是|逃不了|不要脸|的|特|没谱|特|离谱|的|不|作为|简直|就是|美国|人|的|灾难|怜悯|那些|热爱|生命|的|人|全球|一直|宇宙飞船|一般|爆发|彻底|沦陷|看来|一年半载|是|控制|不住|了|真是|人类|的|大灾难|西方|国家|开始|要|自由|的|代价|太大|了
这|不|还是|拜|你|所|赐|嘛|冤有头|债有主|美国|毒王|特朗普
越来越|多|的|美国|人|在|付出|努力|只有|你|没有
该死|的|政客|们|你们|欺骗|了|平民|的|选票|还有|生命
有点|小坏|坏|挺|希望|特朗普|核酸|检测|出|阳性|的
为什么|还|不|定为|疫区|国
哎|呦|这个|东西|不|需要|上|热|搜|吧|希望|把|资源|空|出来|以后|每|十万|报|一次|就行了|还|早|着|呢
没什么|段子|只|希望|不要|危害|我国
雪崩|之前|每|一片|雪花|都|不是|无辜|的|政府|以|政治|和|利益|为主|民众|以|自由人|权|为主|对待|病毒|毫无|敬畏|之心|之前|看|中国|热闹|口头|捐赠|实属|不该|大家|捐赠|需谨慎|前车之鉴|除非|你|质量|过硬|符合|欧盟|标准|要不然|告|你|个|倾家荡产
病毒|美国|不错|适合|我
这次|的|病毒|有三大|特点|一|特|特殊|之前|大家|都|没见|过|二|浪|能够|到处|传播|特别|浪|三|普|普遍|男女老幼|都|可|感染|所以|这个|病毒|我们|可以|命名|为|特浪普|病毒
疯王|我|最|懂|病毒
病毒|魔镜|魔镜|告诉|我|我|的|主人|在|哪里|美丽|我要|美丽|我要|变成|川普迷
一个月|前|老特|我们|只有|15|例|很快|就|会|归零|整个|疫情|完全|在|控制|当中
他|又|知道|了|马后炮|和|自打|脸|之间|反复|切换
we|need|back|to|work
我信|你|个|鬼
我|很|奇怪|为啥|他们|专家|不|出来|说|每次|都|是|特朗普|在|胡说八道
确诊|这么|多|死亡|这么|多|都|是|大|统领|的|功劳|啊
不|懂|就|问|美国|流感|和|电子|烟|肺炎|怎么|突然|消失|了|就|只有|新冠|肺炎|了|么
特朗普|手势|看|懂|的|吗|就|那么|一点点
特狼普|的话|不要|信</comments>