<source>专业版微博平台</source>
<title>#2名新冠肺炎康复者殴打医院CT技师# 被打者头部遭重击</title>
<time>2020-3-30 20:52</time>
<url>https://weibo.com/2028810631/IB2yHwKSZ</url>


<text>新浪|新闻|2020|3|30|20|52|来自|专业版|微博|平台|2|名新冠|肺炎|康复者|殴打|医院|CT|技师|被打者|头部|遭|重击|近日|有|网友|爆料|湖北|汉川市|一|CT|技师|在|工作|时间|遭到|新冠|肺炎|康复者|殴打|一份|文件|疑似|记录|事件|经过|打人者|将|黄|医生|推到|在|地|打掉|其|眼镜|抓伤|其|前胸|出现|了|几十道|血痕|↓|↓|30|日|汉川市|人民|医院|宣传科|回应|此事|更|多|细节|曝光|↓|↓|OCT|技师|遭|两名|新冠|肺炎|康复者|殴打|警方|介入|CT|技师|遭|两名|新冠|肺炎|康复者|殴打|警方|介入|3|月|30|日|有|网友|爆料|称|3|月|27|日|湖北|汉川市|人民|医院|CT|室|技师|黄腾|在|工作|时间|遭到|两名|新冠|肺炎|康复者|殴打|30|日|下午|红星|新闻|从|汉川市|人民|医院|宣传科|获悉|此事|属实|...</text>
<comments>这种|人|直接|火化|了|吧
重判|坐牢|医药费|自费
你|配治好|吗|你|就|该|在家|隔离|等|死
所以|不要|指望|中国|医患|关系|有|改善|疫情|还|没|过去|又|开始|打人|了
判刑|这个|人真|没良心|被|狗|吃|了
我们|的|法律|应该|保护|我们|的|白衣天使
今春|新版|农夫|与|蛇
麻烦|直接|枪毙
尼玛|是|谁|把|你|救命|的|纵然|有|天大|的|怨气|也|不能|打|医生|啊|他们|是|你|的|再生父母|寒心|呐
完全|不|奇怪|医患|纠纷|并|不会|因为|这次|疫情|就|得到|根本|的|改善|关键|还是|要|看|国家|想|不想|彻底改变|这些|国家|想|做|就|没有|做|不到|的|就|像|对待|酒驾|一样
医护人员|冒|着|生命危险|挽救|他们|他们|不知|感恩|反而|恩将仇报|把|他们|的|资料|公开出来|入刑|严叛
新冠|是不是|会|并发|狂犬病
查一查|他们|近期|有没有|不明|资金来源|尤其|海外|的|我|怀疑|故意|捣乱|间谍活动
建议|先|把|新冠|治疗费|掏|了|这种|人|没|必要|国家|给|掏钱|治|再|赔偿|医生|给|医生|下跪|道歉|最后|送|去|判刑|然后|把|他|踢|出|医保|名单
恩将仇报|农夫|与|蛇
希望|警方|跟|院方|别|天天|尼玛|的|只会|和稀泥|一级|响应|下|出现|这种|情况|该|怎么|处理
危急|的|时候|就|把|人家|捧|为|英雄|好|了|就|不|认人
打人者|名叫|李运祥|陈梓涵|请|曝光|他们
当|我|步入|神圣|医学|学府|的|时刻|谨|庄严|宣誓|我|志愿|献身|医学|热爱祖国|忠于|人民|恪守|医德|尊师|守纪|刻苦钻研|孜孜不倦|精益求精|全面|发展|我|决心|竭尽全力|除|人类|之|病痛|助|健康|之|完美|维护|医术|的|圣洁|和|荣誉|救死扶伤|不|辞|艰辛|执着|追求|为|祖国|医药卫生|事业|的|发展|和|人类|身心健康|奋斗终生
看来|科室|老师|说|的|没错|不要|太|乐观|也|就|疫情|期间|你|是|块儿|宝|疫情|过后|你|还是|块儿|臭|狗屎
恩将仇报|严惩|不怠|如此|禽兽不如|的|畜牲
得|了|个|新冠|脑子|也|坏掉|了|吧
对|技师|黄腾|进行|手机|摄像|扯掉|其|口罩|撕烂|其|防护衣|打掉|其|眼镜|将|其|推到|在|地|抓伤|其|前胸|出现|了|几十道|血痕|居然|还|拿出|手机|摄像|这是|一场|有|预谋|的|单方面|殴打|吧|摄像|是|为了|什么|向|别人|炫耀|他们|有|能耐|把|医生|打|了|吗
医生|是|最难|干|的|职业|明明|是|人|病人|却|要求|你|做|天使|达|不到|病人|的|要求|你|就是|魔鬼
什么|垃圾|都|给|治|好|了
医闹|能|不能|入刑|看着|这|类|新闻|越来越|多|真的|寒心
呵呵|对|犯罪分子|还|如此|打码|对|受害者|却|公布|姓名|我特|么|真是|服|了
必须|依法|处置
让|他们|补交|治疗|费用|再|重判
那么|多人|失去|了|生命|这样|的|人|却|活着|他们|配|吗</comments>