<source>专业版微博平台</source>
<title>#美国一女子确诊新冠肺炎后失踪# ：身份地址均为假 已构成“公共卫生风险”</title>
<time>2020-3-18 14:08</time>
<url>https://weibo.com/2028810631/IzaMHF5hQ</url>


<text>新浪|新闻|2020|3|18|14|08|来自|专业版|微博|平台|美国|一|女子|确诊|新冠|肺炎|后|失踪|身份|地址|均|为|假|已|构成|公共卫生|风险|当地|时间|17|日|美国|新泽西州|纽瓦克|市|市长|拉斯|巴拉|卡称|该市|一名|身份|不明|女子|正在|构成|公共卫生|风险|巴拉|卡|表示|该名|女子|已|被|确诊|新冠|肺炎|但是|其|提供|了|假|的|身份|和|住址|目前|可能|仍|在|社区|自由|活动|O|美国|一|女子|确诊|后|失踪|身份|地址|均|为|假|已构|...|美国|一|女子|确诊|后|失踪|身份|地址|均|为|假|已|构成|公共卫生|风险|p|当地|时间|17|日|美国|新泽西州|纽瓦克|市|市长|拉斯|巴拉|卡称|该市|一名|身份|不明|女子|正在|构成|公共卫生|风险|巴拉|卡|表示|该名|女子|已|被|确诊|新冠|肺炎|但是|其|提供|了|假|的|身份|和|住址|目前|可能|仍|在|社区|自由|活动|p</text>
<comments>这集|我|看过|各国|都|一样
问问|特朗普|他|肯定|知道|在|哪里
还|不是|被|你们|账单|给|吓|的
歪|果仁|的|素质|也|一样|不高|啊
这|就是|老美所|向往|的|自由
让|你们|双标|抹黑|落井下石|这|充满|自由|的|气息|好闻|吗
失踪|还有|这种|操作|...
那|北京|那个|黎某|也|是|确诊|之后|没有|隔离|跑|到|中国|是不是|在|美国|也|构成犯罪|了
演|电视剧|呢|失踪|了
其实|这是|新冠|化身|女子|在|测试|防疫|程度
疫情|是|一面|照妖镜|管|他|美国|英国|还是|什么|国|分|分钟|让|妖精|们|现原形
原来|你们|生活|在|那么|高尚|的|地方|也|会|有|如此|的|垃圾
垃圾|到处|都|有
以|美国|的|彪悍|作风|此人|一定|会|被|发现|她|的|警察|当场|击毙
枪|是|干嘛|用|的|发现|直接|请|他|吃|花生米
好|耶|✌|🏻
没事|美国|有药
怎么|可能|会|失踪
这|就是|🇺|🇸|的|自由|吗|爱|了|爱|了
得病|了|不是|应该|赶紧|就医|吗|瞎|跑|什么
转发|微博
估计|是|黑民|不想|暴露|身份
已经|确认|阳性|为何|会|让|她|走|这才|是|严重|的|失职|呵呵|你们|彼此|彼此
确诊|了|还|能|跑|了|也|是|没|谁|了|这是|怎么|教育|的
特朗普|说|没人|比|我|更|懂|这个
在|国外|这样|容易|被|击毙|的
人家|也|有|逃跑|的|人权|鸭|👿
这是|逃窜|到|其他|州|去|了</comments>