<source>专业版微博平台</source>
<title>武汉父母#强行带疑染新型肺炎孩子离境被捕#</title>
<time>2020-1-27 11:54</time>
<url>https://weibo.com/2028810631/Irp74cceE</url>


<text>新浪|新闻|2020|1|27|11|54|来自|专业版|微博|平台|武汉|父母|强行|带疑染|新型|肺炎|孩子|离境|被捕|1|月|25|日|父母|带疑|感染|新冠|病毒|的|孩子|在|马来西亚|士乃|机场|试图|离境|被|警方|逮捕|一家|三口|来自|武汉|2|岁|孩子|出现|新冠|肺炎|症状|医院|要求|其|隔离|检查|但|父母|称要|搭|次日|航班|飞往|广州|带|孩子|从|医院|逃走|医院|报警|后|三人|在|机场|被捕|世面|L|世面|的|秒|拍|视频</text>
<comments>慕洋|犬|与|犬|丧葬|委员会|委员长|我|替|全|广州|人民|谢谢|马来西亚|警方
砥砺|前行|--|这样|的|人|就|该|判刑
家有|糯米|团|真|丢|国人|的|脸
梦里|和|许光汉|翻云覆雨|这样|的|人|不|该当|父母
Crystal|的|星盘|星座|塔罗|害|孩子|还害|别人|怎么|想|的
昵称|vvvxxx|就是|这种|憨|批太多|了|跟|吃|野味|的|也|是|一路|人|有点|小钱|地球|都|要|围着|他|转|自私自利|的|东西
桐桐|桐桐|不得了|这|人|脑子|还|正常|吗|国外|的|医疗|就|可以|救|你|是不是|不|相信|国家|力量|真想|诅咒|一家子|都|死|了|算了
我|就是|小|幂峰|ff|这种|人|不配|当|父母|如果|孩子|真的|病|了|就要|赶紧|治|呀|居然|还|逃|这种|人|应该|关|起来
玫瑰|与|莲白|心|跟着|身体|坏掉|了
初见|8866|明知|自己|是|病毒|携带者|不|及时|治疗|却|乱跑|去|祸害|别人|这种|行为|是|不道德|的
Echou118|武汉|人|这次|真是|秀足|了|下限
朱雀|生|南方|给|马来西亚|的|警方|点赞
阿儀|嘢|他们|怎么|想|的
第|几座|灯塔|让|你|心动|这|就是|武汉|父母|的|样子
Beverlyyy|emm|无话可说
马克|Q|先森|你|孩子|是|孩子|所以|就|可以|不顾|他人|的|生命|健康|吗|你|孩子|是|钻石|做|的|吗|你|一个|孩子|比|其他|许多|人|的|生命|还|值钱|非常|时期|对于|这种|禽兽|就|该|枪毙|艹
堂本|千离|广东|人民|不|欢迎|滚
v30|替代品|诶|在|异国他乡|可能|心里|多少|有些|不|落地|的|感觉|吧|理解|但是|不|赞同|不|支持|还是|要|大局|为重
SUNSUN27|广州|人|做|错|了|什么|这|几天|浙江|广东|人数|上涨|的|太快|了
_____|清|湮|为什么|要|跑|啊|跑出去|自己|病能|自己|好|吗|飞|广州|是|准备|再害|广州|一波|吗|无法|理解
等|爱|的|季节|ILOV|广东|不|欢迎|你们
七块|贰|九|的|生活|这种|人|不配|当|父母|死|的|应该|是|他们|或许|我|言辞|过激|但|看到|这种|新闻|我|真的|很|气愤
AmoebaLee|我滴|妈|太|丢人|了|好好|在|当地|医院|治疗|也|是|好|的|啊
我|爱|蓝天白云|等|太阳|害人害己|丢|尽|了|脸
小|酒窝|啧啧|抓|这样|的|人|害死|人|啊
夜|不语|丶|丶|跑|就|有用|了|准备|自杀|还是|传染|别人
august|kkw|昨天|在|脸书|就|被|马来西亚人|骂|翻|了
光明|小天使|圣剑|建议|这样|的|逃犯|判|死刑
Miss|碧|LinglingLee|请|马来|警方|让|他们|多|坐|几年|监狱|吧|还|想|做|恶意|传染源|把|国人|的|脸|都|丢光
独居|森林|的|猫|真是|丢|中国|人|的|脸|不知死活|的|自私|的|人</comments>