<source>专业版微博平台</source>
<title>上海启动重大突发公共卫生事件一级响应机制</title>
<time>2020-1-24 15:07</time>
<url>https://weibo.com/2028810631/IqY5SiMM2</url>


<text>新浪|新闻|2020|1|24|15|07|来自|专业版|微博|平台|已|编辑|新型|冠状病毒|肺炎|最新|情况|上海|启动|重大|突发|公共卫生|事件|一级|响应|机制|上海|启动|一级|响应|1|月|24|日|市政府|召开|新型|冠状病毒|感染|的|肺炎|疫情|防控|工作|会议|听取|新型|冠状病毒|感染|的|肺炎|疫情|防控|领导小组|办公室|有关|情况汇报|会议|决定|上海|启动|重大|突发|公共卫生|事件|一级|响应|机制|严格|落实|国家|关于|新型|冠状病毒|感染|的|肺炎|乙类|传染病|采取|甲类|管理|的|要求|实行|最|严格|的|科学|防控|措施|进一步|落实|对|重点|地区|来|沪|人员|实行|居家|或|集中|隔离|观察|14|天|全面|实行|各类|进入|本市|交通|道口|卫生|检疫|取消|各类|大型|公共|活动|细化|落实|各项|联防|联控|措施|加强|健康|卫生|知识|宣传|普及|增强|市民|自我|健康|意识|确保|上海|市民|健康|和|城市|公共安全|O|上海|启动|重大|突发|公共卫生|事件|一级|响应|机制</text>
<comments>Rx|Tai|山东
心里|有个|橙|重庆|重庆|重庆|重庆|啥时候|能|启动
宅|就是|为|社会|做|贡献|野味|好|啊|野味|妙|野味|吃|完|骨灰|飘|喝|了|一碗|蝙蝠|汤|火葬场|里|睡|得|香|尝|了|一碟|穿山甲|寿衣|穿|的|要|典雅|吃|了|一块|鳄鱼|肉|地府|里开|个人|秀|别人|在家|过|新年|吃|野味|的|数|冥钱|今天|野味|吃|下肚|明天|就|在|棺材|住|反正|住|了|没人|哭|因为|他们|没|父母|尘归|尘土|归土|医闹|不|配有|父母|别人|在家|过|除夕|医闹|全家|过头|七
他|优秀|他|很|优秀|江苏
卡卡|个|星球|希望|各区|疫情|透明化|希望|各区|疫情|透明化|希望|各区|疫情|透明化|希望|各区|疫情|透明化|希望|各区|疫情|透明化|希望|各区|疫情|透明化|上海|发布
小|杨|又|饿|了|yu|山东|你|急|一急|山东|你|急|一急|山东|你|急|一急|山东|你|急|一急|山东|你|急|一急|山东|你|急|一急|山东|你|急|一急|山东|你|急|一急|山东|你|急|一急|山东|你|急|一急|山东|你|急|一急|山东|你|急|一急|山东|你|急|一急|山东|你|急|一急|山东|你|急|一急|山东|你|急|一急|山东|你|急|一急|山东|你|急|一急|山东|你|急|一急|山东|你|急|一急|山东|你|急|一急|山东|你|急|一急|山东|你|急|一急|山东
星岛|未晴|WB|建议|各|大城市|乡镇|都|启动|一级|响应|吧
养農|上瘾|一定|可以|闯过|难关
佛系|女孩|今天|不佛系|福建|福建|福建|福建|福建|福建|福建|福建|福建|福建|福建|福建|福建|福建|福建|福建|福建|福建|福建|福建|福建|福建|福建|福建|福建|福建|福建|福建|福建|福建|福建|福建|福建|福建|福建|福建|福建|福建|福建|福建|福建|福建|福建|福建|福建|福建|福建|福建|福建|福建|福建|福建|福建|福建
今天|没有|犯病|成都
bittersweet|c|山东|公安|山东|发布|山东|醒醒
正在|背书|的|考|编人|山东
HTKMJ4085251208718|你|什么|时候|反应|过来|重庆|发布
你|喜欢|的|人|是|谁|__|是|肖战|啊|上海|终于|启动|了|吗
syunwn|山东|瞅|瞅|人家|山东|瞅|瞅|人家|山东|瞅|瞅|人家|山东|瞅|瞅|人家|山东|瞅|瞅|人家|山东|瞅|瞅|人家|山东|瞅|瞅|人家|山东|瞅|瞅|人家|山东|瞅|瞅|人家|山东|瞅|瞅|人家
2|零|2|陆|山东|快点|启动|啊
执筆|話情|希望|一切|都|能|尽快|好|起来|🙏
一盏|伴夏|上海|终于|有|动静|了
西西|可苏|成都|成都|成都|成都|成都|成都|成都|成都|成都|成都|成都|成都|成都|成都|成都|成都|成都|成都|成都|成都|成都|成都|成都|成都|成都|成都|成都|成都|成都|成都|成都|成都|成都|成都|成都|成都|成都|成都|成都|成都|成都|成都|成都|成都|成都|成都|成都|！
一块|暴躁|的|肥肉|黑龙江|黑龙江|醒醒|黑龙江|黑龙江|醒醒|黑龙江|黑龙江|醒醒|黑龙江|黑龙江|醒醒|黑龙江|黑龙江|醒醒|！|！
粉碎|杏仁|山东|发布
今天|看书|了|吗|no|江西|江西|江西|恳请|江西|启动|一级|响应|抄|作业|吧|江西|日报
云小兮|总是|留有|遗憾|山东|什么|时候|启动
爱|在|村口|吹泡泡|在|上海|简直|太难|了
不如|我们|简单|点|上海|终于|启动|了
煮|雪|问|茶味|啊|重庆|一级|响应|一级|响应|一级|响应|一级|响应|一级|响应|一级|响应|一级|响应|一级|响应|一级|响应|一级|响应|一级|响应|一级|响应|一级|响应|一级|响应|一级|响应|一级|响应|一级|响应|一级|响应|一级|响应
加仓|大吉|京津沪|都|一级|了|直辖市|的|渝|呢|会|不会|启动|要|理智|应对|呀
大|韩冥国|传统|服饰|hanbok|上海|加油
CACTUZS|看|你|都|是|笔芯|的|形状|安徽|安徽
Avocado|西西西|广东|广东|广东|广东|广东|广东|广东|广东|广东|广东|广东|广东|广东|广东|广东|广东|广东|广东|广东|广东|广东|广东|广东|广东|广东|广东|广东|广东|广东|广东|广东|广东|广东|广东|广东|广东|广东|广东|广东|广东|广东|广东|广东|广东|广东|广东|广东|广东|广东|广东|广东|广东|广东|广东|广东|广东|广东|广东|广东|广东|广东|广东|广东|广东|广东|广东|广东|广东|广东|广东</comments>