<source>专业版微博平台</source>
<title>#福建新增3例确诊新型冠状病毒肺炎#</title>
<time>2020-1-23 11:16</time>
<url>https://weibo.com/2028810631/IqN9L50qc</url>


<text>新浪|新闻|2020|1|23|11|16|来自|专业版|微博|平台|福建|新增|3|例|确诊|新型|冠状病毒|肺炎|新型|冠状病毒|肺炎|最新|情况|今天|11|时|福建省|报告|新增|输入|性|新型|冠状病毒|感染|的|肺炎|3|例|其中|厦门市|泉州市|宁德市|分别|报告|1|例|确诊|病例|均|为|当地|首例|确诊|病例|新增|患者|均|为|武汉|返乡|人员|目前|患者|病情|平稳|正在|接受|隔离|治疗|追踪|到|的|密切接触|者|正在|接受|医学观察|央视|新闻</text>
<comments>熊熊|部落|如果|您|来自|疫区|您|曾|到|过|武汉|或|接触|过|从|武汉|回来|者|尽量|不去|接触|别人|持续|观察|自己|的|健康状况|14|天|请|自觉|居家|观察|14|天|这是|一种|觉悟|更是|一种|责任|也|关乎|您|和|您|家人|的|健康|谢谢您
凯旋|几度|夏|ooO|别|在|往|出|跑|了|行不行|东三省|确诊|的|都|是|武汉|返乡|的|🙏|🙏
金主|哥|一|刷新|一|增加|真的|害怕|了
今天|没有|犯病|如果|您|来自|疫区|您|曾|到|过|武汉|或|接触|过|从|武汉|回来|者|尽量|不去|接触|别人|持续|观察|自己|的|健康状况|14|天|请|自觉|居家|观察|14|天|这是|一种|觉悟|更是|一种|责任|也|关乎|您|和|您|家人|的|健康|谢谢您
谭晶|老师|的|提词|器|武汉|返乡|...|武汉|怕|担责任|求|wd|的|政府|高层|看看|你们|干|了|些|啥
小严|先|睡|了|球球|在|武汉|的|福建人|别|回来|祸害|家人|了
5y|佩佩佩|zi|昨天|不|还|刚刚|发现|一个|今天|三个|南平市|你|要|稳住|啊啊啊
感觉|值得|就|继续|这|病毒|是|要|把|全国|给|嚯|嚯|一遍
今天|没有|犯病|会|好|的|会|好|的|会|好|的|会|好|的|会|好|的|会|好|的|会|好|的|会|好|的|会|好|的|会|好|的|会|好|的|会|好|的|会|好|的|会|好|的|会|好|的|会|好|的|会|好|的|会|好|的|会|好|的|会|好|的|会|好|的|会|好|的|会|好|的|会|好|的|会|好|的|会|好|的|会|好|的|会|好|的|会|好|的|会|好|的|会|好|的|会|好|的|会|好|的|会|好|的|会|好|的|会|好|的|会|好|的|会|好|的|会|好|的|会|好|的|会|好|的|会|好|的|会|好|的|会|好|的|会|好|的|会|好|的|会|好
叽哩|芒果|武汉|加油|福建|加油|中国|加油
吕哥|在|北京|那些|爱|吃|野味|的|就|该|滚出|中国|就|不会|有|这么|多|麻烦事|了
九万个|曜|不得|鸭|🙏|🙏|🙏|🙏|🙏|🙏
孤峰|弯|月|太|可怕|了
Delilah|已|注册|祈福|中国|加油
小梨养|了|只|小猪|ouo|我|靠|我|靠|我|靠|还|真的|以为|朋友圈|的|消息|是|假|的|人|一定|要|注意安全|⚠|️
听闻|雨声|滴答|武汉|加油|🙏
立立|飘|了|宁德|人民|心慌慌
养猪|专业|兔|z|想|问|一下|厦门|的|是|在|哪个|区
窝|long|宁德|人民|瑟瑟|发抖
是|源味|薄荷糖|呀|在|小|屏南|的|我|慌|了|宁德|也|有|了
陈陈超|有料|能|不能|别|再|放人|回来|了|想全|中国|的|人|都|被|感染|吗
Amaranta|--
冰摇赞赞|黑加仑|🙏|🙏|🙏
乘|热气球|和琳琳|一起|私奔|越来越|多|还有|好多|没报
Wang|雨|r|为什么|有|很多|医院|明明|有|却|不报
越|沅|福建|也|沦陷|了
郑微|wei|瑟瑟|发抖|..|真的|怕|了
li|鹿過|我|在|想|这些|病毒|会|不会|传染|动物|会|的话|可|就|麻烦|了|鸟类|到处|飞|不是|没法|控制|么|然后|传染|老鼠|老鼠|传染|宠物|在|到|人|想想|就|可怕|了
Liucminmin|那|4|人|到底|在|哪|吓|得|我|不敢|出门|不要|害人|呐|¡|评论|配图
SpeedyDuck|武汉|返乡|的|这么|多|都|确诊|了|这个|概率|估计|武汉|本地|实际|感染|的|不止|几百人|吧</comments>