<source>专业版微博平台</source>
<title>感谢有你！湖北黄冈#百余名医务人员主动请缨抗击疫情#</title>
<time>2020-1-24 14:56</time>
<url>https://weibo.com/2028810631/IqY1juPWy</url>


<text>新浪|新闻|2020|1|24|14|56|来自|专业版|微博|平台|感谢|有|你|湖北|黄冈|百余名|医务人员|主动|请缨|抗击|疫情|1|月|22|日|湖北|黄冈|当|听说|要|在|惠民|医院|成立|定点|收治|医院|时|35|岁|的|医生|周耿|立即|将|自己|的|两个|孩子|送到|父母|身边|主动|向|医院|请缨|抗击|疫情|在|他|的|带动|下|医院|100|余名|志愿者|纷纷|报名|周耿说|心里|怕|但是|不能|后退|要|全力以赴|L|时间|视频|的|微博|视频</text>
<comments>哲学|姐|现在|感染|源|都|扩散|到|全国|官员|们|还有|闲心|开|晚会|医生|护士|连|防护|都|不足|去|医院|都|没有|车|拿|什么|抢救|病人|拿|什么|保护|自己|湖北|的|官员|们|每天|在|干什么|为什么|严重|到|这个|程度|非典|时期|王|市长|临危受命|从|海南|调|到|北京|湖北|是不是|也|该|学学
饭圈|囧|事|奋斗|在|一线|的|医疗|人员|你们|辛苦|了|为|您们|点赞
美白丸|日本|铂金|美白针|pola|人胎素|湖北|不是|只有|武汉|望|周知
宅|就是|为|社会|做|贡献|17|年前|的|非典|是|医护人员|冲|在|最前|17|年|后|的|新型|肺炎|又|是|他们|最先|面对|危险|哪有什么|岁月|静好|不过|是|有人|替|我们|负重|前行|如果|这|世上|真有|守护神|那|一定|是|医生|的|模样
执筆|話情|致敬|所有|医护人员
理是|人间|妄想|致敬|都|要|平平安安|归来
屿|迹|甜栗|山东
亿|个头|戴|鹿角|的|小妞|都|要|平平安安|的|啊
云水|林蔓|哭|了
想|睡|太子|哪有什么|岁月|静好|不过|是|有人|在|替|你|负重|前行|这|世上|总|有人|在|创造|伟大|致敬|所有|的|医护人员|一定|要|平安|归来|期待|你们|的|好消息
奇|好看|谁|能|不怕死|呢|都|是|放下|了|自己|为了|大家|罢了|各位|医护人员|保护|好|自己|患者|积极|配合|早日|和|新型|病毒|say|拜拜
莎圈|迪迦|我|好|害怕|我|好|害怕|我|好|害怕|我|好|害怕|我|好|害怕|我|好|害怕|我|好|害怕|我|好|害怕|我|好|害怕|我|好|害怕|我|好|害怕|我|好|害怕|我|好|害怕|我|好|害怕|我|好|害怕|我|好|害怕|我|好|害怕|我|好|害怕|我|好|害怕|我|好|害怕|我|好|害怕|我|好|害怕|我|好|害怕|我|好|害怕|我|好|害怕|我|好|害怕|我|好|害怕|我|好|害怕|我|好|害怕|我|好|害怕|我|好|害怕|我|好|害怕|我|好|害怕
这|就|由不得你|了|好样|的|湖北|加油
Dear|明|对于|这|一群|人|永远|都|值得|身为|为|人|的|我们|尊敬|爱护|因为|他们|就是|和平|年代|敢于|赴死|的|英雄|致敬
猴猴|不吃|糖|想|哭
谷嘉诚|抛弃|冷帽|后援会|保护|我方|医护人员|给|人发|防护
养農|上瘾|致敬
xlei74|湖北|的|ld|是|足|邪|出来|的
孤|不|喧|病魔|肆虐|自然|会|有人|收
快乐|的|三爱|堂主|英雄|们|注意安全
风满楼|QAQ|1
寻找|迷失|的|大象|定点医院|没人管|看看|红十字会|医院|死者|在|走廊|没人管
梦家|小涵|超级|感谢|医务|工作者
老佛爷|SH|医护人员|都|是|英雄|一定|要|平安
韩|韩锋锋|突然|想到|别处|的|一句|话|人性|的|光辉|都|是|用来|给|权利|的|祸祸|填坑|医生|幸苦|了|保佑|你们|健康
大肥|考拉|致敬|你们
坚果|最|幸福|三十多年|的|人生|中|第一次|春节|过成|这样|小|县城|封城|了|政府|官网|挂|出来|的|文件|说|是|启动|四级|应急|其他|的|省|都|启动|一级|响应|了|那么|多|从|武汉|工作|读书|回来|的|人|都|在|大街|上|到处|流动|与|大城市|的|所有|交通|都|切断|了|只能|买|到|涨价|的|豆腐渣|防尘|口罩|医用|口罩|买不到|有个|万一|以小|县城|的|医疗|手段|也|只有|等|死
心安|归处|512|医护人员|的|基本|防护|都|做|不到|可是|湖北|官员|都|在|干什么
所有|教授|请|保护|好|医护人员
随|你|而行|看到|这个|新闻|热泪盈眶|他们|也|是|父母|的|孩子|他们|也|是|孩子|的|父母|敬佩|平安|归来</comments>