<source>专业版微博平台</source>
<title>#新型冠状病毒中间宿主或是水貂#！传染病权威专家解读</title>
<time>2020-1-26 07:36</time>
<url>https://weibo.com/2028810631/IrdZTtgrl</url>


<text>新浪|新闻|2020|1|26|07|36|来自|专业版|微博|平台|新型|冠状病毒|中间|宿主|或是|水貂|传染病|权威专家|解读|北京大学|工学院|生物医学|工程系|教授|朱怀球|团队|1|月|24|日|发表|的|研究|文章|提示|蝙蝠|和|水貂|可能|是|新型|冠状病毒|的|两个|潜在|宿主|其中|水貂|可能|为|中间|宿主|该|研究|深度|学习|算法|预测|新型|冠状病毒|的|宿主|和|感染性|发表|于|bioRxiv|预|印版|平台|据|了解|该|研究|使用|的|是|基于|深度|学习|算法|开发|的|VHP|病毒|宿主|预测|方法|用以|预测|新型|冠状病毒|潜在|宿主|研究|提示|与|感染|其他|脊椎动物|的|冠状病毒|相比|蝙蝠|SARS|样|冠状病毒|与|新型|冠状病毒|具有|更|相似|的|感染|模式|此外|通过|比较|所有|宿主|在|脊椎动物|上|的|病毒|传染|模式|发现|水貂|病毒|的|传染性|模式|更|接近|新型|冠状病毒|课题组|成员|之一|浙江大学|医学院|第一|医院|传染病|诊治|国家|重点|实验室|副|主任|肖永红|解释|说|研究|发现|新型|冠状病毒|与|其他|冠状病毒|有|相似|的|传染|过程|蝙蝠|身上|有|多种|冠状病毒|这些|冠状病毒|可能|先|传染|至|哺乳动物|再|传染|到|人|比如|MERS|病毒|中间|宿主|就是|骆驼|对于|新型|冠状病毒|来说|研究|预测|蝙蝠|是|它|的|最|主要|来源|中间|宿主|可能|是|水貂|而|关于|新型|冠状病毒|的|感染力|朱怀球|团队|研究|表明|新型|冠状病毒|的|6|个|基因组|都|极|有|可能|感染|人类|预测|结果|提示|新型|冠状病毒|具有|与|严重|急性|呼吸|综合征|冠状病毒|SARS|CoV|蝙蝠|SARS|样|冠状病毒|Bat|SARS|like|CoV|和|中东|呼吸|综合征|冠状病毒|MERS|CoV|类似|的|感染|人类|的|强大|潜力|昨天|中国|疾控中心|首次|公布|成功|分离|的|我国|第|一株|病毒|毒种|信息|及其|电镜|照片|肖永红|解释|说|这|对于|研究|病毒|致病|机制|药物|研发|都|非常|有|帮助|奠定|了|非常|好|的|基础|通俗|地说|全|基因组|序列|找到|了|贼|的|证据|现在|是|把|贼|抓住|了|健康|时报</text>
<comments>Miisuqki|Tokyo13th|希望|这次|风波|过去|国家|严打|贩卖|野生动物|最好|是|纳入|刑法|对|食用|野生动物|的|采取|举报|有奖|机制|我|身边|有|亲戚|在|吃|野生动物
平行|时空|de|幸存者|这|是|啥|居然|还有|人|吃
甜甜|爱|吃|兔|兔|吖|同样|都|是|人|那些|吃|野味|的|怎么|就|没有|脑子|呢
抹|茶|焦糖|半微凉|il|水貂|也|特|么|吃|吃|野味|biss
我|的|表锅|是|城里人|水貂|都|有|吃|的
柠萌|西西|不管|是|什么|野生动物|都|不能|吃|第一|病毒|细菌|多|第二|要|保护|生物|多样性
茶人|茶味|tea|年|后|的|生产|生活|都|会|随之|出现|问题|没有|积蓄|的|家庭|开学|的|学生|年|后|的|工作|想想|都|觉得|可怕
只|做|耶|啵|的|乖|喵|还有|吃|蝙蝠|和|水貂|的|厉害|口味|太重|不要命|啊
和|小|徐|的|中|二|日常|不仅|拿来|做|衣服|了|还要|吃|了
第二个|视角|两个|月|后|终于|开始|展示|科技|的|硬|实力|了
ydw|月|岛雯|这个|研究|成立|了|穿|貂|的|会|不会|被|追|着|打
兮|夜|昭昭|水貂|不是|有|人工|养殖|的|吗|这|都|要|去|吃|野生|的
星弦|之泪|水貂|真的|很|可爱|为什么|要|杀|它|吃|它|皮草|大衣|穿|身上|穿|的|都|是|些|曾经|活生生|的|生命|买家|难道|不会|心痛|的|吗|有|什么|钱|不会|买|更好|的|品牌服装|非要|穿|人家|身上|扒|下来|的|皮毛|做|衣服|现在|又|吃|人家|的|肉|不|残忍|吗
无籽|火|long|果|可能|是|貂皮|工厂|的|工人|我|的|表锅|是|城里人|水貂|都|有|吃|的
想象|的|答案|先|把|吃|野味|的|那些|畜牲|一网打尽|他们|才|是|病毒|的|根源
沙耶加|水貂|用来|做|衣服|还|不够|么|你|咋|还要|吃|人家
要|你|拐|吃|野味|和|贩卖|野味|的|biss
严|州府|大郎|貂|都|能|吃|可怜
强迫症|高级|患者|水貂|那么|可爱
夕弭|节兮北|渚|水貂|那么|可爱|怎么|可以|吃|水貂
因为|我|是|Holly|每天|醒来|看微博|最|希望|的|就是|看到|好消息|三个|字|今天|晚上|又|梦|到|了|中国|加油
基哥|de|鹰眼|感觉|这|跟|猪肉|涨价|有|关系|要|不|那些|人|怎么|会|饥不择食|去|吃|水貂|呢|就|跟|生育率|低|跟|房价|有关|是|一个|道理
逝雪|留香|吃|什么|都|瞎|吃|我|记得|SARS|好像|就是|吃|出来|的|🙈
浩然|观|世界|牛蛙|还|能|吃|么
我|其实|是|一颗|萌|豆儿|人要|敬畏|自然
多|睡觉|别|熬夜|会|秃|貂皮大衣|的|貂
菜|菜鹅|鹅|那|貂|还|能|穿|吧|东北|挺|冷|的
WilliamLee|威廉|希望|疫情|好转|🙏|🙏|🙏
Amy|小橋|转发|微博
杨|紫|的|小可爱|丫|真的|不要|吃|野味|了</comments>