<source>专业版微博平台</source>
<title>#宠物接触到疫情也需隔离#！李兰娟称如接触到疑似患者一样要隔离</title>
<time>2020-1-30 09:32</time>
<url>https://weibo.com/2028810631/IrQsThpBu</url>


<text>新浪|新闻|2020|1|30|09|32|来自|专业版|微博|平台|已|编辑|宠物|接触|到|疫情|也|需|隔离|李兰娟|称|如|接触|到|疑似|患者|一样|要|隔离|据|国家|卫健委|数据|截至|1|月|29|日|24|时|全国|累计|报告|确诊|病例|7711|例|现有|重症|病例|1370|例|累计|死亡|病例|170|例|全国|共有|疑似病例|12167|例|李兰娟|主人|要|对|宠物|加强|管理|如果|宠物|在|外面|接触|到|疫情|接触|到|病人|那|宠物|也|需要|监控|起来|这个|病毒|是|在|哺乳动物|之间|传播|所以|我们|对|哺乳动物|也|需要|加以|防备|L|中国|网|直播|的|微博|视频</text>
<comments>演员|不|加糖|不|出去|接触|别的|人|动物|就|没事
予|我|长安|别|遗弃|它们|只有|你|了
枲|耳|看到|几条|评论|有些|来|气|不要|对|李兰娟|院士|阴阳怪气|她|是|实实在在|的|传染病|专家|她|刚刚|分离|出|三株|冠状病毒|毒株|在|非典|时|表现|也|很|突出|她|只是|把|实情|告诉|大众|她|并|没有|让|养|宠物|的|人|扔掉|自己|的|宠物|只是|要|自己|为|自己|养|的|宠物|负责|如果|有人|因为|怕死|自己|扔掉|了|宠物|也|不是|她|的|错
绱|剧终|服|了|人家|说|的|是|看管|好|自己|的|宠物|避免|出去|接触|病原|因为|这次|的|病毒|传染|是|在|哺乳动物|之间|脑子|清楚|的|人|就|知道|不是|让|你|弃养|宠物|扑杀|流浪|猫|狗|心理|是|有|多|扭曲|第一|时间|就|想|弄死|猫|狗|除了|猫|狗|猪|牛羊|都|是|哺乳动物|多|了|你|倒|是|去|杀|呀|缺心眼
满糖|羊羊|宠物狗|没有|口罩|戴|怎么办|啊|不要|抛弃|它们|做好|防范措施
丶|瑪莎|玛莎|半个|月|都|没敢|出门|遛狗|了|要|好好|保护|我家|狗|🙏
猫|医生|猫|行为学|宋|猫猫|小姐姐|请|各位|保护|好|我们|的|主子|们|猫猫|狗狗|他们|的|世界|只有|我们
尕|瓦绒姆|是|人会|传染给|宠物|好好|保护|的|宠物|不会|传染给|人|遗弃|宠物|的|人|和|杀害|流浪|动物|的|人|睁|大|你|的|狗眼|给|👴|看清楚|了
i|KDLWHCXZTizen|唉|这种|消息|一出|我要|赶快|说|一句|丢弃|宠物|的|全部|司马
不会|瘦|了|Zz|世界卫生组织|人民日报|央视|新闻|丁香|医生|都|明确|辟谣|目前|没有|任何|证据|表明|这次|的|冠状病毒|会|传染给|猫|狗|所以|隔离|是|必要|安全|的|隔离|猫|狗|还|不|简单|吗|本身|就|一直|隔离|也|不用|太|担心|顶|我|上去
ZhangFangShuo|李兰娟|院士|的话|被|中国|网|直播|歪曲|直接|冠上|宠物|也|会|感染|新型|肺炎|的|名号|这|对|猫|狗|可能|是|灭顶之灾|希望|大家|跟|我|一起|去|举报|投诉|这种|行为|根据|权威|媒体|没有|任何|证据|猫狗会|感染|新型|肺炎|请|不要|遗弃|猫|狗
猫咪|的|下午茶|时光|希望|大家|不要|弃养
Agioia|四个|权威|平台|包括|世卫|组织|都|说|了|没有|证据|只有|这|一句|话|是|上|了|热|搜|的|天津|开始|捕杀|金鱼|和|宠物|龟|马上|又|开始|捕杀|流浪|猫|狗|一边|是|不负责任|的|主人|随意|遗弃|一边|是|城管|人员|无脑|捕杀|解决问题|的|方法|就是|靠|杀光|那|怎么|不去|捕杀|蝙蝠|每种|生物|都|有|存在|的|意义
百变基|面包|应该|是|想|说|动物|的|皮毛|接触|到|病菌|没有|及时|消毒|人|在|接触|动物|皮毛|后|有|被|感染|的|风险|吧|那|就|给|宠物|穿衣服|再|遛|进门|擦|脚|或者|不|出门|总之|这|不是|抛弃|宠物|的|理由
王欢儿|er|人民日报|不是|说|了|吗|带毛|的|衣物|是|病毒|存活|时间|最短|的|吗|人家|宠物|全身|都|是|毛|请|不要|在|这里|发|敏感|信息|造成|大量|宠物|流浪
乔|小羊|Q|我天|真的|搞不懂|我家|狗|我|就|养|了|一年|我|都|做好|了|共存亡|的|心|还|想|了|要是|我|被|隔离|了|怎么|安置|它|它会|不会|想|我|这是|家人|啊|怎么|可以|随手|就|扔|呢|？
aa|阿薇|vvv|隔离|不|等于|抛弃
昇|基|and|维尼|你|一个|官博|如此|造谣|不怕|有|报应|？
阳光|很|幸福|所谓|流浪狗|猫|群体|在|壮大|始作俑者|也|是|人类|没|责任心|玩腻|了|扔|病|了|扔|造成|它们|不断|繁衍|恶性循环|所以|人类|也|应从|自身|找|原因|没|责任心|耐心|爱心|就|不要|养|它们|送来|送|去|遗弃|都|是|一种|不负责任|和|伤害|所谓|善始善终|才|正确|真的|爱|狗狗|带|狗狗|出门|请|一定|给|狗狗|带|牵引绳
重温|遗憾|外面|的|流浪|动物|怎么办|啊|难道|又|要|开始|作孽|吗|要|捕杀|吗|千万别|啊|人类|做|的|孽|已经|太多|了
哎呀|百万|能|不能|过过|脑|再|说话|都|够|恐慌|了|你|能|把|可以|证明|宠物|能够|感染|新型|肺炎|的|证据|摆出来|吗|整个|视频|有|说|过|宠物|会|感染|吗|意思|说|的|是|外出|宠物|可能|会|沾染到|好|吗|难道|你|外套|会|沾染上|病毒|我|就|可以|说|你|外套|感染|了|接触|到|疫情|当然|要|隔离|但|你|视频|上|写|也|会|感染|这种|目前|还|没有|任何|证据|证明|的|事情|是|何|居心|啊
小龙虾|包子|先|管好|人|吧|人|都|乱窜|还管|宠物|呢|起码|宠物|不会|传到|其他|地区
变温动物|Fan|流浪|猫|狗|怎么办
猫咪|的|下午茶|时光|病毒|会|在|哺乳动物|之间|传播|有|猫|的|关猫|有|狗|的|关狗|不要|散养|不要|弃养
四海|八荒|唯一|的|辣条|一大|篇|话|都|是|废话|谁|不|知道|加以|防备|啊|你|要是|有|学术|成果|直接|说|传染|就|传染|作为|特殊|时期|一个|所谓|专家|不要|说|模棱两可|的话|造成|对|家养|宠物|的|伤害
姗爷|要|攒钱|买超|多|HP|周边|能|不能不要|再用|这个|视频|了|这个|标题|误导|群众|啊|微博|辟谣|李兰娟|院士|只|说|因为|宠物|同|为|哺乳动物|所以|如果|宠物|接触|了|患者|同样|需要|一视同仁|隔离|观察|加以|防备|没有|一句|话|暗示|及|表示|宠物|确认|会|感染|并|传染给|人类|这样|的|标题|和|造谣|会|让|社会|上|许多|无辜|宠物|被|抛弃|扑杀|引起|社会|恐慌|和|生灵涂炭
脆皮|月球|不|遛狗|不|就|解决|了|猫|一般|都|在|家里
Clrove|7|借此|遗弃|宠物|的|祝|你|和|吃|野味|的|一个|报应
小|羙|Silvia|不要|遗弃|不要|遗弃|不要|遗弃|宠物|的|一生|只有|你|只要|在|家里|绑|好|不|出门|不|接触|陌生人|养它|做好|你|应该|负责|的|它|就|不会|有事
田|小西|世界卫生组织|官方|微博|已经|辟谣</comments>