<source>iPhone 7 Plus</source>
<title></title>
<time>2020-2-14 01:09</time>
<url>https://weibo.com/1496883514/Iu3LuiMkg</url>


<text>凯雷|2020|2|13|23|04|来自|iPhone|7|Plus|已|编辑|有|一百多位|朋友|质疑|我发|的|21|岁|武汉|的|大学|女|研究生|救助|洪湖|母亲|的|微博|是|带|节奏|和|有|编造|是|真的|她|的|身份证|她|妈妈|的|身份证|她|的|学生证|她|在|学校|的|照片|她|和|她|妈妈|的|视频|照片|都|发给|了|我|感谢|大家|监督|我|也|不会|打码|我|就|这个|妹妹|自己|打下|码|我|这|发出|来|我|是|真|不会|打码|以后|救助|的|朋友|要|一定|打码|你们|就|自己|打下|我|也|实在|无|时间|分享|图片</text>
<comments>那些|人|都|是|红色|水菌|吧
带|他|妈|得病|啊|带|最烦|听到|带|节奏|几个|字
微博|这么|乱|了|啥|都|是|在|带|节奏|还是|啥|都|成带|节奏|了
这有|什么|需要|求证|的|做人|得|先|善良| |救人|第一
说|带|节奏|的|就是|一群|没有|同情心|的|人
居然|还有|100|多位|朋友|动不动|就|质疑|这|质疑|那|的|之前|多少|人|求助无门|上博|求助|被|骂|最后|排|不到|床位|离去|了|这些|质疑|者|就|开心|了|吗|很多|事要|证据|没错|但是|还|得|就事论事|啊|没有|证据|就是|带|节奏|就是|造谣|这|不|就是|8|勇士|被|造谣|的|原因|凯总|把|这些|朋友|拉|黑|吧
我|觉得|他们|才|是|在|带|节奏|---|从|另|一个|方面|来|带|节奏|他们|跟|在|元旦|的|那篇|微博下|叫好|谩骂|的|人|应该|是|同|一类
这个|妹子|妹都|尝试|了|申报|了|还有|微博|肺炎|超话|不是|救急|无门|我|都|尽量|不转|统一|最后|一次|回复|100|个|朋友|逆战|200907|你|自|认为|是|救世主|吗|为什么|不|直接|把|国务院|的|专用|申报|投诉|方式|告诉|需要|救助|的|人|/|东|綦潭|一切|都|可能|假|/|/|清风徐来|细雨绵绵|继续|带|节奏|不是|傻|你|是|坏
一切|都|可能|假
我|相信|您|🙏|🙏
也|可以|把|蛆|挂一挂|不用|客气
凡是|说|带|节奏|的|都|是|沙币|不是|蠢|就是|坏|我|吃|你|了|喝|你|了|凭|什么|要|和|你|节奏|一样
为什么|21|岁|不|可能|是|研究生|读书|早|不行|吗|智商|高|跳级|不行|吗|有些|人|总|把|别人|跟|自己|比|自己|做|不到|别人|也|不|可能|做到
说|别人|带|节奏|的|人|本身|就是|为了|搅乱|水|激化矛盾|想|挑拨|我们|的|社会|安宁|他们|并|不想|了解|什么|事实真相|他们|只想|人身攻击|激化|人民|对|zf|的|不满|这群|动不动|就|说|别人|带|节奏|的|人|很|有|可能|是|真正|的|敌特
哪些|扣帽子|的|才|是|带|节奏
转发|微博

雷总|说|你|带|节奏|的|人|都|是|whzf|派|出来|的|喷子
请|问候|这|一百多位|朋友|的|妈
不要|质疑|医院|饱和|医护|紧缺|民众|真的|很难|很苦|能|帮忙|的|就|帮帮|吧|/|Mossad|数据|站|这有|什么|好|怀疑|政府|口号|喊|再响|他们|也|是|人|不是|神|可以|瞬间|收拾|完|每|一个|患者|🙃
红卫兵|们|好|恐怖|哦|啥|也|扯|上|带|节奏
/|天空|的|一片|云|520|此|女孩|刚刚|发|的|新|一条|微博|显示|其|生母|现已|火速|收住|洪湖|康华|医院|多亏|了|凯|总|不吝|搭救
现在|有些|人|的|精力|就是|用来|质疑|了|不能|做点|好事|吗
可以|没有|良心|但|不能|没有|脑子
什么|情况
湖北|这么|多人|感染|了|就|目前|公布出来|的|能|收治|的|病床|这么|少|肯定|还有|很多|没有|得到|救助|的|人|连|国家|都|已经|再三|呼吁|应收|尽收|了|这|就|已经|说明|问题|了|那些|怀疑|的|人|应该|都|是|想要|粉刷|太平|的|人|吧|这种|人|都|是|一些|没有|同情心|的|人
要|转|宁可|错转|不能|错过|那|是|人命|马虎|不得

他们|其实|是|妒忌|研究生|才|21|岁|不|信|这么|小
回复|凯雷|的|表态|啊|啊啊啊|啊啊啊|啊|被凯|总点|赞|了|我|明白|我|等|你|回来|！</comments>