<source>微博 weibo.com</source>
<title>世卫组织总干事：将到中国了解新型肺炎疫情</title>
<time>2020-1-27 10:35</time>
<url>https://weibo.com/1618051664/IroAV7HyK</url>


<text>头条新闻|2020|1|27|10|35|来自|微博|weibo|com|世卫|组织|总干事|将|到|中国|了解|新型|肺炎|疫情|世界卫生组织|总干事|谭|德塞|26|日|说|他|正在|前往|中国|的|路上|将|到|中国|了解|新型|冠状病毒|感染|肺炎|疫情|并|与|中国|官方|和|有关|专家|商讨|疫情|防控|措施|谭|德塞|当天|在|社交|媒体|上|说|他|将|与|中国政府|代表|和|卫生|专家|商讨|如何|应对|新型|冠状病毒|感染|肺炎|疫情|世卫|组织|团队|将|实地考察|疫情|最新|情况|并|与|中方|进一步|加强|在|防控|方面|的|合作|谭|德塞|说|世卫|组织|正|努力|为|处于|这个|困难|时期|的|中国|人民|提供|支持|并|与|其他|受|影响|国家|保持|密切联系|同时|世卫|组织|正向|所有|国家|通报|疫情|最新|情况|并|就|如何|应对|提供|指导|他|说|世卫|组织|已|启动|全球|专家|网络|以|迅速|为|各国|提出|建议|新华网</text>
<comments>世卫|组织|总干事|要来|了|湖北|政府|命令|一位|画家|创作|一幅|名为|医护人员|在|前线|的|大型|油画|作为|献礼|画|完成|后|湖北|一|高官|前来|验收|结果|让|他|大吃一惊|画面|上|是|自己|在|看|联欢晚会|医护人员|呢|高官|问|医护人员|在|前线
千万别|被|判定|为|疫区|国|不然|将|成为|国际|的|隔离|对象国
重新|评估|国际|突发|公共卫生|事件|吗|？
只要|全体|中国|人|戴|口罩|在家|呆|着|15|天|然后|潜伏期|的|都|暴露|出来|去|医院|了|筛选|层层|各个|人|健康人|就|全部|安全|了|这|是|对|经济|打击|最小|的|方法|如果|不|这样|做|人人|传人|人|第二代|第三代|层出不穷|岂|不是|没完没了
将|责任|提升|到|世界|高度|人类|加油
快点|控制|住|吧|大|中国|一路|走来|不|容易|绝不能|被|疫情|绊住|脚|苍天|有眼|天佑|中华
世界卫生组织|感谢
这|应该|是|不怎么|好|吧|是不是|要|重新|判定|我们|是不是|疫区|国
好不容易|对外|建立|的|大国|形象|因为|吃|野味|腐败|官吏|官商勾结|又|要|回到|解放前|了|这些|人|不仅|让|全国|为|他们|的|无耻|用|血泪|买单|还|让|中国|再次|成为|世界|的|笑柄
希望|数字|不要|再|增加|了|也|该|给|世界|一个|交代
有|的|人|还是|傻|一|但|升级|将会|影响|中国|的|贸易|经济|一下子打|回|解放前
蔡|英文|在|剁|脚
人类|命运|共同体
感谢|感谢|中国|需要|世界|先进|医疗|科技|的|协助
希望|进展|顺利
这个|年太难|了|不过|再难|我们|都|能|扛过去
那个|市场|的|女老板|和|那些|贩卖|食用|的|都|应该|抓|起来|不|给|带|口罩|去|搬运|因|病毒|死|掉|的|尸体
支援|中国|世界|有责
还是|要|遭|世界|曝光
最|可怕|的|不是|疫情|扩散|而是|明明|扩散|了|还|不|承认|一些|网友|到|这时候|还|说|是|美国|的|阴谋|还|支持|隐瞒|疫情|可见|武汉|领导|还是|有|不少|粉丝|的
多多指教
加油
谢谢你们
该|怎么|判|怎么|判|现在|把|疫情|控制|住|最|重要|啊|就|怕|传染给|更|多|的|人
🙏
相信|科技
世卫|请|给|我们|医生|和|护士|还有|前线|的|战士|们|最好|的|防护|设备
都|啥时候|了|才|来
来晚|了
确诊|人数|上|了|2000|世卫|又|来|钦差大臣|了</comments>