<source>微博 weibo.com</source>
<title>“你给我聚堆儿，我就对你不客气”！各地大喇叭大PK</title>
<time>2020-1-28 14:53</time>
<url>https://weibo.com/1618051664/IrzI3aTH3</url>


<text>头条新闻|2020|1|28|14|53|来自|微博|weibo|com|滚蛋|吧|新冠|肺炎|你|给|我|聚|堆儿|我|就|对|你|不|客气|各地|大|喇叭|大|PK|你|不要|以为|你|上|人家|去|人家|就|很|欢迎|你|你|给|我|聚|堆儿|我|就|对|你|不|客气|随着|新型|冠状病毒|疫情|的|发展|各地|的|防护|措施|越来越|多样化|为了|引起|村民|们|的|重视|各地|的|大|喇叭|开始|了|广播|宣传|央视网|L|小央|视频|的|秒|拍|视频</text>
<comments>说|的|完全正确|你|不要|以为|你|上|人家|去|人家|就|欢迎|你|各自|为阵|自觉|隔离|直到|安全期
你|不要|以为|你|上|人家|那去|人家|就|很|欢迎|你|了|你别|太|自信|了
河南|赢|了
其实|想想|现在|戴|口罩|挺|好|的|不仅|能|防病毒|还|能|保暖|有时候|还|觉得|挺|好看|呢
东北|的|村支书|们|东北|方言|也|支棱|一下子|被
还有|这句|红|哒|哒|白|哒|哒|你|真能|哒|哒
那些|造谣|地|你|都|歇歇|吧|还|不|嫌|乱|吗
为啥|配|音乐|干扰|我|听|领导|讲话
哈哈哈|这些|干部|太|可爱|了
哈哈|啊哈|哈哈哈哈|我们|村子|也|是
要|的|就是|这么|硬核
虽然|农村|没|那么|发达|但是|很多|事|都|比|城市|做|的|好
滚滚|滚
那些|造谣|的|你|都|歇歇|吧|还|不|嫌|乱|吗|说|的|太好了
太|接地|气|了
我|就|不|客气
李不浪|i
晓華|髙|这样|实在|有些|野蛮|不让|人|出去|村子|里|的|人|不能|去|县城|买|东西|家里|都|没|啥|菜|了|你|可以|把|村口|的|路|封|了|去|县城|的|路|根据|要求|登记|测体温|你|直接|给|封|了|这么|野蛮|我|不|知道|是|哪个|领导|说|的|政策|不是|这样|的|啊|陕西|宝鸡|扶风|城关镇
这样|实在|有些|野蛮|不让|人|出去|村子|里|的|人|不能|去|县城|买|东西|家里|都|没|啥|菜|了|你|可以|把|村口|的|路|封|了|去|县城|的|路|根据|要求|登记|测体温|你|直接|给|封|了|这么|野蛮|我|不|知道|是|哪个|领导|说|的|政策|不是|这样|的|啊
你|别以为|上门|提着|酒|我|就|开心|了
我们|这|还是|照样|聚集|打麻将|我|微博|搜|也|有|很多|人|抱怨|有|同样|情况|如果|真的|希望|疫情|得到|控制|真的|希望|强制|监管|不然|根本|没用|一些|地方|的|人|还是|照样|不带|口罩|聚集|喝酒|打麻将
有些|是|自主|模拟|村大|喇叭|不管|怎么样|支持|全面|阻击|病毒
笑|死|我|了|不管|你|有|病|没病|先|把|你|隔离|起来
中国|🇨|🇳|特色
乡镇|大|喇叭|立|了|大功
最后|一句|是|安徽|的|吧|好|可爱|啊
山西省|忻州市|静乐县|政府|没有|认真|做好|防御|肺炎|措施|现在|很多|人|不|戴|口罩|并|聚众|聊天|打牌|社区|乡镇|都|没有|贯彻落实|山西|启动|的|一级|响应|措施|置|人民|利益|于|不顾|希望|得到|重视| |防病治病| | |人人有责|🙏|🙏
你们|停下|了|出行|的|脚步|其实|就是|刹住|疫情|前行|的|脚步|留在|家中|就是|你们|抗击|疫情|最大|的|奉献|和|牺牲
宝鸡|警方</comments>