<source>微博 weibo.com</source>
<title>#北京小汤山医院正在重建# 有望重启应对疫情</title>
<time>2020-1-28 15:59</time>
<url>https://weibo.com/1618051664/IrA8V9Z8j</url>


<text>头条新闻|2020|1|28|15|59|来自|微博|weibo|com|北京|小汤山|医院|正在|重建|有望|重启|应对|疫情|1|月|28|日|记者|从|多方|信源|获知|建于|2003|年|曾|作为|治疗|非典|病毒|患者|专用|医院|的|北京|小汤山|医院|正在|重建|并|有望|在|近日|重新|启用|下午|3|点|记者|赶赴|至|北京市|昌平区|小汤山|疗养院|小汤山|医院|的|前身|北门|处|得知|疗养院|内部|已|施工|两到|三天|建筑队|和|医生|均|有|入驻|目前|施工方|为|北京|建工|和|北京城|建|界面|新闻|°|北京|小汤山|医院|正在|重建|有望|重启|应对|疫情|头条新闻||北京|小汤山|医院|正在|重建|有望|重启|应对|疫情</text>
<comments>希望|每个|省|都|要|准备|起来|啊|防范|于未然|就算|最终|用不上|做|发热|专科|也|是|好|的
能|直播|重建|吗|我|想|当|网络|包工头
没想到|轮回|的|周期|竟然|是|17|年|而|不是|按|属相|来
加油|啊
北京政府|从来|都|是|低调|运转|方向|把|控|基层|落实|从|人员|核查|摸底|到|停|庙会|停|大型|活动|停|长途|客|运输|地铁|戴|口罩|测温|到|今天|停|部分|铁路运输|坚持|把|回京|潮|控制|好|是|关键|就是|如果|口罩|消毒液|等|防护用品|充足|就|更|安心|了|下|一个|7|天是|关键
北京|也|爆发|疫情|了|吗
闷声|干|大事
小汤山|疗养院|的|病人|早就|在|阴历|二十九|就|有|陆续|搬出|了|给|改造|滕|空间|这个|是|非常|有|前瞻性|的
这是|说明|病人|还会|更|多|好|害怕|呀
不|应该|拆除|留着|应对|突发事件|加油|北京
建议|小汤山|模式|的|医院|在|疫情|过后|不要|拆|全部|改建|成|传染病|研究|治疗|中心
防患于未然|大家|不必|惊慌
致敬|每|一位|工作人员|从|目前|情况|看|看病难|和|住院|难|的|问题|有|了|很大|程度|的|缓解|中国|加油|武汉|加油|我们|为|医疗|服务|点赞|👍
暴风雨|后|的|彩虹|更美|致敬|逆|行者|武汉|加油|中国|加油
武汉|加油|中国|加油|ง|•|̀|•|́|ง
早点|集中|起来|有|上次|经验|希望|这次|能够|更|快|压制住
快些|过去|快些|过去|保佑
转发|微博
记得|之前|还有|去|探访|废弃|后|的|小汤山|医院|的|视频|没想到|啊|没想到|废早|了
未雨绸缪|☔|️|建议|各个|城市|都|应该|做好|准备|因为|及时|隔离|是|防止|疫情|扩散|的|最|关键|的|措施
加油
加油
怎么|个|意思|病人|要|大幅|增加|吗|怕
下次|国家|储备|一定|要|储备|一百亿|只|口罩
希望|广东省|也|提前|做好|准备|有备无患
加油
小汤山|和|雷|神山|火神|山|医院|经验|之后|建议|一是|全国|省会|城市|务必|提前|规划设计|建设|或|可|改造|专门|传染病|防控|医院|二是|武汉市|尽快|建|第三第四|个|小汤山|医院|三是|湖北|严重|地市|建|自己|的|小汤山|医院|缓解|武汉|的|压力|四是|周边|严重|病例|省份|马上|新建|或|改造|小汤山|医院|疫情|刻不容缓
未雨绸缪
网球|申奥</comments>