<source>专业版微博平台</source>
<title>#希腊首例新冠肺炎确诊病例#</title>
<time>2020-2-26 19:48</time>
<url>https://weibo.com/2028810631/Iw12xhUKS</url>


<text>新浪|新闻|2020|2|26|19|48|来自|专业版|微博|平台|已|编辑|希腊|出现|首例|新冠|病毒|确诊|病例|希腊|首例|新冠|肺炎|确诊|病例|当地|时间|2|月|26|日|希腊|卫生部门|宣布|在|希腊|北部|第一|大城市|塞萨洛尼基|出现|希腊|第一例|新型|冠状|病毒感染者|该|患者|为|38|岁|希腊|女性|近期|曾|前往|意大利|旅行|央视|新闻|关注|新浪|新闻|立即|了解|你|所在|的|小区|有无|确诊|病例|最近|的|疫情|小区|距|你|有|多|远|实时|信息|更新|中|↓|↓|O|了解|周边|确诊|信息|了解|周边|确诊|信息|实时|动态|追踪</text>
<comments>这个|病毒|传染性|很强|希望|你们|能|重视|起来|加强|防疫|措施|提高|国民|防疫|意识|疫情|不|分|国界|希望|你们|能|挺住|啊
病毒|已经|满|世界|跑|了
奥运|圣火|采集|不久|将要|举行|病毒|是|去|希腊|埋伏|了
不要|嘚|瑟|了|都|老实|儿地|封城|隔离|等|疫情|过去|了|再|出来|我们|的|方法|是|现行|唯一|可行|方法|抱|侥幸心理|的|日|韩|都|沦陷|了
去|旅游|都|感染|了|意大利|的|实际|感染|人数|怕|是|不|低|啊
看看|丹麦|小|饼干|还|敢不敢|嚣张
要|重视|啊|外国|的|友|人们
在|农村|这边|的|老|人们|已经|不|当回事|了
国与国|之间|先|暂停|人员|往来|不|可以|吗
已经|全球|开始|蔓延|了|唉
欧洲|人员|也|很|密集|啊|希腊|和|意大利|是|邻邦|不|加以控制|的话|整个|地中海|沿岸|都|会|很快|扩散|的|🙏|🙏
现在|还是|感觉|中国|安全|封|小区|限制|出行|什么|的|太|安全|了
丹麦|🇩|🇰|🇩|🇰|🇩|🇰|🇩|🇰|怎么|还|没|呢|急|死|我|了
坐标|希腊|雅典
天呐|加油|希腊|🙏|🙏|🙏|🙏|🙏
连锁反应
那|意大利|岂|不|就|相当于|前段时间|的|武汉|了
也|不|知道|都|第几代|传染|了|最|开始|防|武汉|后来|防|湖北|再|后来|防|中国|防|中日韩|范围|越来越|大|越来越|不好|控制
地球|一直|在|转动|这个|圆画|的|太快|人类|猝不及防|不管|你|在|哪里
加油|💪
完|了|这下|是|真|tm|点亮|全球|了
公布|基因|数据|吧|据说|有|很多|不同|的|基因组|越来越|怀疑|病毒传播|里面|的|问题|了
我|.......|日
冠冠|环游世界
厉害|了|全世界|还有|几个|没有|的
怎么|都|有|了
疫情|对于|全球|都|是|个|考验|还是|小心|点|吧|别|让|疫情|回流
希望|彻查|美国
下午|看到|日本|东京|奥运会|圣火|即将|在|希腊|采集|的|新闻|还|担心|起|希腊|了|没想到|担心|成真|了</comments>