<source>专业版微博平台</source>
<title>#马克龙探望医院全程无人戴口罩# 专家警告：法国或成下一个意大利</title>
<time>2020-2-29 17:29</time>
<url>https://weibo.com/2028810631/IwspiifVK</url>


<text>新浪|新闻|2020|2|29|17|29|来自|专业版|微博|平台|马克|龙|探望|医院|全程|无人|戴|口罩|专家|警告|法国|或|成下|一个|意大利|2|月|27|日|法国|总统|马克|龙|前往|收治|法国|本土|首例|新冠|肺炎|死亡|病例|的|医院|探望|他|与|一线|医护人员|一一|握手|但|交流|全程|无人|佩戴|口罩|一名|传染病|专家|指出|法国|已经|存在|本土|传播|链|可能|成为|下个|意大利|当日|另一名|医生|与|马克|龙|对质|要求|增加|对|公共卫生|投入|资金|新冠|肺炎|最新|海外|动态|L|世面|的|秒|拍|视频</text>
<comments>外国人|少|不是|没有|原因|的
胆真大|敬|你|是|条|汉子
总统|安全|团队|安全意识|太弱|了|吧
碰鼻|碰面|吻|手礼|再来一个|呗
天呐|马克|龙|心得|多大
虽然|长|的|帅|但|病毒|也|爱
检查|也|没用|这位|医生|说|的|没错|公立医院|已经|瘫痪|了|要钱|没钱|要|资源|没|资源|而|私人|医院|不是|慈善机构
还|没|意识|到|疫情|严重性
很|亲民|的|总统|希望|未来|这|段时间|每天|都|这样
下周一|头条|法国|总统|马克|龙新冠|病毒|核酸|检测|呈|阳性|系|全球|首位|新冠|病毒感染|国家元首
欧洲|似乎|对|新冠|肺炎|没有|任何|畏惧
心真大
还是|我们|中国|人|惜命|挺|好|的
非常|时期|就|不|握手|了
过于|相信|自己|国家|医护人员|保障|有力|过度|自信|觉得|自己|百毒不侵
听到|了|没|加大|公|医院|私营|氏|的|结果|没|钱
不是|作|死|就是|摆|拍
如此|大意|我能|说|什么|一一|防火|防盗|防|外国
头铁克龙
现在|世界|上|还有|哪个|国家|能|像|中国|一样|几天|起好|两座|医院|来|收治病人|的|中国|人|在|这种|时候|应该|更要|庆幸|自己|是|中国|人|啊
这|是|最|基本|的|礼仪|戴|口罩|表示|不|尊重
都|是|有|武汉|官员|的|思想觉悟|与|行动|的|人
太|没有|安全意识|了|算你狠
是|下|一个|伊朗|啊|全是|高官
绝|了|都|不|害怕|吗
得|不得|的|永远|在|骚动
医生|也|没|戴|口罩|啊
没|钱|啥|都|不行|马克|龙想|戴|口罩|被|拍|到|可|了不得|算了|死|扛|到底|呗
我|感觉|已经|是|脑子|有|问题|的|层面|了
抓|起来|先|强制|隔离|十四天</comments>