<source>专业版微博平台</source>
<title>称“‘主’能治病毒” #韩国牧师全光勋被拘留#</title>
<time>2020-2-25 12:43</time>
<url>https://weibo.com/2028810631/IvOPtdruL</url>


<text>新浪|新闻|2020|2|25|12|43|来自|专业版|微博|平台|已|编辑|称|主|能治|病毒|韩国|牧师|全光勋|被|拘留|日前|首尔|市|宣布|在|多个|广场|暂停|集会|以防|疫情|扩散|但|保守派|团体|违反|禁令|连续|组织|集会|全光勋|发表演说|号召|民众|抗议|政府|称|得病|了|也|是|爱国|主|能|治愈|病毒|在|韩国|引发|争议|首尔|市政府|已|向|警方|举报|违反|选举法|的|牧师|全光勋|当地|法院|已|对|他|发布|逮捕令|韩国|集会|组织者|预告|下周|继续|全光勋|被|拘留|中|新|视频|L|中新|视频|的|秒|拍|视频</text>
<comments>这是|真的|邪教
愿|病毒|团灭|了|邪教组织
刚看|了|他|慷慨陈词|的|视频|你|后脚|就|告诉|我|他|被|拘留|了
疫情|时期|趁火|浇油|不|抓|他|抓|谁
这个|时候|确实|是|这些|邪教|蛊惑人心|的|时候
新|韩剧|哈利|路亚|的|监狱|生活
把|这货|抓|起来|放到|疫情|病毒|人|一起|他|如果|不|中招|就|承认|他|是|神|如果|中招|了|就让|他|去|见|他|的|神主
任何|个人|的|思想|行为|都|只能|代表|他|自己|就算|他|不是|邪教|即使|他|是|个|牧师|牧师|也|是|人|不能|代表|基督教|他|说|的话|只是|他|自己|这样|认为|不|代表|主要|他|这么|做|请|不要|把|人|的|愚蠢|归咎|到|主|的|身上|神为|人类|背负|无数|罪责|还要|为|悖逆|无知|的|人|背负|骂名|人|真的|是|太|得罪|亏欠|主了
就|像|几年|以前|大陆|的|全能|神
一个|国家|连|一个|邪教组织|都|对付|不了|这|邪教|存在|多长时间|了|祸国殃民|应该|趁|这个|时候|斩草除根|了
新天地|他们|是|邪教|只是|打着|基督教|的|旗号|骗人|希望|不要|弄混|了|🙏
不要|给|基督徒|抹黑|好|嘛
如果|集会|时|一个|教徒|没戴|口罩|跟|他|说|我|感染|了|新冠|肺炎|很|害怕|你|能|抱抱|我|给|我|信心|吗|好|想|知道|这个|全光|勋会|说|什么
信仰|本身|没有|问题|不管|是|佛教|基督|天主|还是|其他|教|但是|总|有些|人|狭隘|的|把|信仰|信邪|了|这是|那些|人|的|问题|信仰|本身|是|为了|让|人|心灵|有|依托|做事|的|时候|有所|畏惧|不至于|什么|都|做|没有|底线|可惜|有些|人|本身|就|不正|于是|信着|信着|就|自己|邪|了
哦|哈利|路亚
基督教|从|诞生|那天|起|就|被|无数|人|给|传歪传|邪|了|为此|的|的|战争|也|不在少数
抓得|好|邪教|疯|了
还有|就是|能|帮|他|理发|不|看着|蛮|膈|应|的
等等|我|想|联想|一下|假设|他|被|抓|了|万一|政府|系统|也|存在|信主之人|那|他|岂|不是|很快|就|被|释放|了|或者|内部|给|他|提供|便利|他|可以|通过|社交|软件|继续|指挥|外边|的|信主|民众|那|这
金光|勋|说好|的|自由|呢
我|脑子里|的|韩国|邪教|只有|四个|字|哈利|路亚
神会|救|他|出去|的|哈利|路亚
洗脑|基督教
哈哈哈哈|想到|那|一脸|得意|的|围笑|转眼|就|被|抓|了
鼓掌|👏|👏|👏
抓|的|好|邪教|简直|祸国殃民
笑|死|我|了|这个|邪教
上帝|送|你|的|监狱|入住|的|机会|哈利|路亚
把|他|和|病人|放在|一起|然后|让|主救|他|吧
韩国|的|废青</comments>