<source>微博 weibo.com</source>
<title>国家卫健委：#武汉发现不明原因肺炎# 正做病毒检测实验</title>
<time>2019-12-31 13:07</time>
<url>https://weibo.com/1618051664/Inj3oCn8z</url>


<text>头条新闻|2019|12|31|13|07|来自|微博|weibo|com|国家|卫健委|武汉|发现|不明|原因|肺炎|正|做|病毒检测|实验|31|日|上午|武汉|出现|不明|原因|肺炎|病人|疑似|非典|一事|引发|关注|中午|新|京报|致电|国家|卫健委|原|卫生部|在|全国|启用|的|12320|卫生|热线|接线员|称|确认|武汉市|发现|不明|原因|肺炎|正在|做|病毒检测|实验|接线员|称|不明|原因|肺炎|不|等于|非典|现在|没有|疫情|最新|通知|希望|公众|勿|恐慌</text>
<comments>武汉|发现|不明|原因|肺炎|专家组|马上|到达|武汉|我|很|想|歪|个|楼|不管|是|出|了|大型|医疗|问题|还是|小|的|头疼|感冒|医护人员|是|真正|的|站|在|那里|治愈|你|保护|你|不管|你|是|什么|人|不管|你|犯|了|什么|错|希望|杨医生|的|事|不要|再|出现|了|希望|此次|只是|小|问题|医护人员|们|还有|所有人|大家|都|能|平安|过年
说个|恐怖|的|事情|今天|跨年|人流量|保底|几百万|大家|最近|还是|少去|人流量|密集|的|地方|吧|坐地铁|戴|口罩|吧|还是|安心|的|待|在|室内|里面|不要|到处跑|了|希望|周围|的|大家|都|平安
我|是|一线|的|医务|工作者|我|相信|最|官方|的|消息|希望|大家|也|一样|🙏|🙏|🙏
嗯|嗯|大家|先|不要|慌张|等|最新|的|官方消息|就|好|了
当年|非典|死|了|多少|医护人员|你们|知道|吗|有|的|还是|一家|都|没|了
不信谣|不|传谣|不要|引起|恐慌
近期|最好|别去|武汉|鸭脖子|也|少|吃
这时候|是|还|没有|耽误|的|节点|但是|1|月|上中旬|确诊|数据|还|在|而|疑似病例|诊断|数据|被|隐瞒|了|可能|是|专家组|可能|是|当地|卫健委|可能|是|当地|领导|总之|有人|吞掉|了|疑似病例|数据|于是|在|没有|试剂盒|时|通过|对|初期|密切接触|者|的|观察|做出|了|有限|人|传人|判断|后续|一发|不可收拾
SARS|的|中文名称|就是|非典型|性肺炎|不是|非典型|性肺炎|但|肯定|也|不会|是|典型|性肺炎|目前|叫|原因|不明|的|病毒性|肺炎|挺|绕嘴|的
要|屯|一些|板蓝根|吗
Zf|也|是|为了|湖北|人民|好|🐶
转|发现|很早
谈|非|色变
贵报|2|小时|之前|说|红头文件|是|假|的
别慌
医药|股|莫名其妙|就|大涨|估计|是|很|严重
非典|已经|是非|典型|性肺炎|了|这回|是|不典
广东|那些|鸟|人|什么|都|吃|就|没有|不吃|的|动物
确实|不|等于|非典|更|严重
这个|病毒检测|结果|多少|个|小时|可以|出来|特别|关心
哪|天|发现|的
明天|是|新年|的|第一天|希望|这个|可怕|事情|有|最好|方法|解决|🙏|🙏|🙏
能|不能|注意|点|都|盖章|扫面件|啦
能|不|慌|吗
今年|元旦|就|呆|家里|好|吧
不明|原因|情况|下|应该|让|公众|做好|预防措施|啊
还是|四季|分明|的|地方|好
扫面件
互联网|记录|的|历史|跟|史书|一样|偶尔|翻开|都|写|着|绝大部分|人|一定|会犯|历史|上|反复|发生|过|的|错误|人性|千年|来|改变|不|大|有|少数|清醒|人|也|改变|不了|电竞|陈柏霖|说个|恐怖|的|事情|今天|跨年|人流量|保底|几百万|大家|最近|还是|少去|人流量|密集|的|地方|吧|坐地铁|戴|口罩|吧|还是|安心|的|待|在|室</comments>