<source>iPhone 7 Plus</source>
<title></title>
<time>2020-6-21 13:25</time>
<url>https://weibo.com/1496883514/J7wqCh782</url>


<text>凯雷|2020|6|20|16|30|来自|iPhone|7|Plus|已|编辑|新|发地|冠状|基因|序列|公布|病毒|来自|欧洲|无疑|再|结合|三文鱼|被|新冠|病毒|污染|情形|看|欧洲|冷冻|食物链|被|污染|输入|境内|可能性|极大|比如|欧洲|水场|工人|去除|鱼鳃|时|病毒|污染|了|三文鱼|极小|的|可能|从|境外|返回|来|的|无症状|感染者|在|市场|处理|整只|冰鲜|或|冰冻|三文鱼|时|传播|了|新冠|病毒|大公网|新发|地新冠|病毒|序列|公布|与|欧洲|流行|病毒|最|接近|记者|任芳|颉|凯雷|北京|报道|6|月|18|日晚|中国|疾病|预防|控制中心|通过|新型|冠状病毒|国家|科技|资源|服务|系统|正式|发布|2020|年|6|月|北京|新发|地新冠|疫情|及|病毒|基因组|序列|数据|三组|基因|序列|显示|新发|地新冠|病毒|序列|与|欧洲|流行|的|新冠|病毒|最|接近|在|欧洲|架构|中|与|来自|葡萄牙|和|瑞典|的|基因|序列|只|相差|1|个|突变|疾控|专家|指出|新|发地|病毒|来自|欧洲|但要|比现|欧洲|流行|的|病毒|要|老|极|可能|与|境外|输入|的|冷链|传播|有关|三条|数据|来自|北京市|确诊|病例|基因组|序列|数据|NMDC60013902|01|NMDC60013903|02|以及|环境|样本|基因组|序列|数据|NMDC60013903|03|中国|疾病|预防|控制中心|同时|向|世界卫生组织|及|全球|共享|流感|数据|倡议|组织|GISAID|提交|了|新冠|疫情|及|病毒|基因组|序列|数据|向|国际|社会|共享|Nextstrain|即刻|在|官方|推特上|发布|据|了解|Nextstrain|由|西雅图|弗雷德|哈钦森|癌症|研究|中心|的|病毒|进化|专家|团队|组织|该|平台|在|本次|疫情|中|负责|聚合|崽子|世界各地|的|新冠|病毒|序列|以|构建|病毒|进化树|谱|此次|公布|的|3|条新冠|病毒基因|序列|均|来自|最近|北京|暴发|的|病毒|样本|这|3|个|序列|落|在|一个|进化|簇中|属于|进化|枝|20B|而|该|进化|枝|常见于|欧洲|与|2020|年|3|月|19|20|日|采样|的|3|个|输入|北京|的|病毒|的|基因|序列|大不相同|在|全球|构架|中|与|该|序列|最|接近|的|病毒|来源于|捷克|中国台湾|希腊|以及|葡萄牙|按|地区|分布|看|在|亚洲|架构|中|北京|的|序列|和|来自|捷克|中国台湾|丹麦|哥伦比亚|以色列|和|奥地利|的|序列|很|接近|在|欧洲|架构|中|北京|的|序列|和|来自|捷克|丹麦|等|许多|欧洲|国家|的|序列|很|接近|其中|和|来自|葡萄牙|和|瑞典|的|基因|序列|只|相差|1|个|突变|由此|表明|此次|北京|新|流行|的|病毒|是|现有|病毒|分支|且|与|欧洲|流行|的|病毒|有关|而|非|由|动物|传染|到|人|的|新发|疫情|因该|病毒|与|多个|国家|和|地区|的|流行|病毒|序列|类似|所以|尚无|法定|论|病毒|的|来源|专家|新|发地|病毒|从|欧洲|来| |或|潜伏|在|进口|冷冻|食品|链中|输入|中国|疾控中心|病毒|病所|所长|助理|张勇|接受|媒体|采访|时|表示|从|基因组|流行病学|的|初步|研究|结果|看|新发|地|的|病毒|是从|欧洲|来|的|但是|它|跟|欧洲|当下|流行|的|病毒|又|有|一定|差别|它|比|现在|欧洲|流行|的|病毒|要|老|张勇|表示|病毒|更|古老|有|以下|可能性|比如|病毒|潜伏|在|了|进口|的|冷冻|食品|当中|在|从|境外|到|境内|的|整个|存储|运输|的|期间|由于|病毒|被|冷冻|没有|发生|进化|所以|不会|发生|变异|也|有|可能|病毒|是|在|新|发地|农产品|批发市场|等|阴暗|潮湿|的|环境|里|潜伏|下来|没有|被|消毒|灭菌|在|一定|时间|内|突然|暴露|感染|人|导致|进化|速度|变慢|最终|我们|看到|的|就是|这些|毒株|更|接近|于|欧洲|老|病毒|O|网页|链接</text>
<comments>新|发地|批发市场|的|三文鱼|来自|京深|海鲜|市场|为何|新发|地|的|三文鱼|的|案板|上|检测|出|病毒|京深|海鲜|市场|所有|样本|都|阴性|京深|海鲜|可是|供应|全|北京|及|附近|省市|我|平时|从京|深买|海鲜|叫|闪|送|二|小时|送达|它|发货|到|全国|各地|如|三文鱼|本身|携带|病毒|全国|全|北京|各处|都|会|炸|为何|单单|新|发地|市场|内|传播
大|概率|是|投毒|了|且|看|以后|特别|是|上海|广州|尤其|是|新病毒|的|出现
北京市|疾控中心|公布|新|发地|采样|有|40|多个|点|采集|到|新冠|病毒|为啥|只|公布|这个|菜|板子|其他|的|不|公布
海关|检测|1.6|万个|进口|海鲜|样品|都|是|阴性|还是|自己|的|问题|老是|阴谋论|会|给|溯源|带来|误导
看到|台湾|会|不会|...
很|奇怪|如果|是|三文鱼|冰鲜|携带|过来|的|病毒|那|其他|大城市|为何|没有|发现|最起码|目前|没有|这方面|消息|那|就是|人|到底|是|市场|里|的|人|还是|国外|回来|的|人|呢|毕竟|核酸|检测|比不上|血清|检测
公开|查封|新|发地|批发市场|三个|月|对|新|发地|市场|员工|全部|检测|对|半个|月|时间|顾客|全部|检测|全国|冷冻|市场|全部|检测|北京|二千万|人|全部|检测
为什么|菜市场|肉类|病毒检测|阳性|最多|的|三文鱼|案板|检测|出新|冠|新天地|内|除了|人类|活体|哺乳动物|还有|一种|活体|就是|所有|菜场|一定|会|有|在|肉类|活动|最|多|哺乳动物|菜场|耗子|他们|肯定|在|肉类|活动区|最|多|而且|国外|己经|有|貂|感染|新冠|并|传播|人|貂|和|耗子|实际|为|一种|哺乳动物|建议|捉|新|发地|耗子|检测|如果|证明|耗子|为|中间|宿主
新发|地新冠|病毒|序列|与|欧洲|流行|的|新冠|病毒|最|接近|在|欧洲|架构|中|与|来自|葡萄牙|和|瑞典|的|基因|序列|只|相差|1|个|突变|疾控|专家|指出|新|发地|病毒|来自|欧洲|但要|比现|欧洲|流行|的|病毒|要|老|极|可能|与|境外|输入|的|冷链|传播|有关| 
出口|转|内销|了|这|是
如果|病毒|真是|依靠|冷链|传播
特殊|时期|吃点|普通|的|自己|家|的|对付|就行了|非要|去|惹事|划不来|劲量|自己|做饭
全面|我|认为|这是|非常|权威|并且|准确|的
在|欧洲|架构|中|北京|的|序列|和|来自|捷克|丹麦|等|许多|欧洲|国家|的|序列|很|接近|其中|和|来自|葡萄牙|和|瑞典|的|基因|序列|只|相差|1|个|突变
欧洲|没本事|没|能力|控制|也|不让|我们|好过|鱼|眼红|了|，
病毒|🦠|的|溯源|很难|了
说得有理|由
最新|权威|消息|中国|疾病|预防|控制中心|经过|仔细|研究|比|对|北京|新|发地|新冠|病毒基因|序列|与|欧洲|流行|的|新冠|病毒基因|序列|最|接近|极有|可能|与|境外|输入|的|冷链|传播|有关
为啥|不|检查|装|三文鱼|的|包装|？
我|就|喜欢|看|评论|科学|不怕|责疑|病毒|来自|欧洲|无疑|应是|误导|应|改为|病毒|与|欧洲|相似|据|基因|测定|此|病毒|比|欧洲|病毒|更|古老|难道|孩子|传给|了|爷爷|冷链|传播|根本|无证据|张口|就|来|病毒|从|欧洲|传来|对|病毒|溯源|更加|困难
转发|微博
建议|搞|刑侦|的|痕迹|鉴定|专家|如|李昌钰|等|大师|介入|调查
从|欧洲|进口商品|全国|只有|北京|吗
加油
他们|还|检测|了|新|发地|未|拆|包装|的|三文鱼|发现|病毒|了|吗
脑子|呢
进口|美国|猪肉|风险|这么|大|怎么|没|报道
恐怖
转发|微博
疾控|专家|都|不敢|这么|说|真的|是|张口|就|来</comments>