<source>微博 weibo.com</source>
<title>刊发“新冠病毒回美国”诗作？#中学生导报辟谣#</title>
<time>2020-4-29 09:08</time>
<url>https://weibo.com/1618051664/IFwLMzYsO</url>


<text>头条新闻|2020|4|29|09|08|来自|微博|weibo|com|刊发|新冠|病毒|回|美国|诗作|中学生|导报|辟谣|针对|网传|中学生|导报|刊登|诗作|新冠|病毒|终于|哭|了|一事|该报|主管|单位|兰州|日报社|28|日|发布|声明|称|前者|的|报刊|号|遭人|恶意|盗用|相关|诗作|并非|中学生|导报|编辑部|选登|声明|还|表示|受|疫情|影响|中学生|导报|2020|年|没有|出版|任何|有关|高考|的|专版|专刊|观察者|网</text>
<comments>对|都|是|网民|自已|做|的|大家|千万|不要|信|虽然|是|真的
教育|的|很|好|培养|了|一堆|蛆虫|连|基本|的|人性|都|丧失|了
三观|不正|的|国人|还是|太|多
不过|写|的|可以
看|评论|真的|惊|了|难怪|外国人|排斥|歧视|中国|人
谁|在|恶意|造谣|病毒|成|了|某些|人|手里|的|武器|长|点心|吧
虽然|对|美国|的|无耻|行径|恨之入骨|但|不|代表|我们|也|要|用|这样|下作|的|方式|去|回敬
额|我|觉得|吧|全世界|善良|的|人|都|应该|平安|幸福
辟|不|辟谣|反正|我|觉得|孩子|写|了|不赖|的|诗
写|了|又|怎么样|美国|天天|抹黑|我们|以其人|之道|还给|他|不行|吗|评论|写|洗脑|洗|的|好|的|为啥|你|就|给|美国|洗脑|了|呢|还|骂|别人|是|蛆|别人|把|你|当狗|你|还|美滋滋
美狗|又|要|来|说教|跟|你|谈|人性|了|丫丫|的|我|觉得|它|找|错|对象|了|它|应该|去|跟|美国|政客|谈|人性|去|对|美国|人|说教|不过|可惜|了|它们|只是|人家|的|狗|而已|狗|哪|有|资格|对|主子|说教|它们|也|就|能|在|中国|的|土地|吠|而已
盗|刊号|这个|解释|很|机智
这种|报纸|也|有人|盗
恶意|盗用
洗脑|成功|了
哈哈哈|好|诗
美国|突破|一百万|大关|了
还|查出来|个|盗版书|商
文采|不错
这有|什么|问题|嘛|只许|老|美|放火|不许|我们|点灯
写|就|写|了|有|啥|好|辟谣|的
刘杰|EdenLau|此|编辑部|有|一项|开展|了|多年|的|业务|就是|紧密结合|时政|凭借|高超|的|政治|敏锐度|结合实际|突然|今年|就|有人|盗号|了|还|刻意|发了|一篇|诗歌|您|辛苦|了
有些|媒体|转发|谣言|跑|的|比|香港|记者|还|快|辟谣|消息|就|权当|没|看到
现在|错误|过|几天|内容|可能|就|正确|了|就是|抢跑|了|吧
公知|高潮|了
这诗|自己|开|开玩笑|就|好|不要|大肆|传播|呀
那|又|是|谁|写|的|发表|在|哪|呢</comments>